key point: điểm chính, điểm quan trọng|the first key point
across the U.S, across the country: trên toàn nước mỹ, trên khắp cả nước
even though, even if: mặc dù
turn to: quay sang
up to now: đến nay
ever since: kể từ đó
almost this week: gần tuần này
miss out: bỏ lỡ
not at all: không có gì
enjoyed your stay: tận hưởng kì nghỉ của bạn
rock climbing: leo núi
mountain biking: đi xe đạp leo núi
helping verb: trợ động từ
remain the same: vẫn như cũ|train insane or remain the same 'tập luyện điên rồ'
just a minute please: vui lòng đợi một phút
interest rate: lãi suất
it is certain: chắc chắn
in conjunction with(idiom) kết hợp với
rush hour(n) giờ cao điểm
brush up(phrasal verb) ôn luyện
run an errand: làm việc vặt
a full range: đầy đủ
hardly ever: hầu như không bao giờ
leisure center(n) trung tâm giải trí
sales executive: giám đốc bán hàng
lead to: dẫn đến
result in: dẫn đến
house plant: cây cảnh trong nhà
come with: đi kèm với
come up with: đưa ra
toll free: miễn phí
become familiar with: nắm rõ
all the whole: nói tóm lại
figure out: tìm ra
locker room(n) phòng thay đồ
over the buildings: trên các tòa nhà
line up(phrasal verb) xếp hàng
might be: có thể là
head office: trụ sở chính
magazine subscription: đặt báo dài hạn
traffic jam: tắc nghẽn giao thông
break out(phrasal verb) nổ ra| before war broke out in 1939.
take off(phrasal verb) cởi ra|to take off your coat
put on(phrasal verb) mặc vào|to take off your coat
cut down(phrasal verb) cắt giảm|I'm trying to cut down on fatty foods.
check-up(n) khám, kiểm tra|a health check up 'kiểm tra sức khỏe'
also known as(aka) được biết đến như là|Antonio Fratelli, aka ‘Big Tony’
improve their spirit: cải thiện tinh thần
prior to: trước|during the week prior to the meeting
decided to\make a dicision: quyết định
worked as\serve as\act as: làm việc như là
came up with the idea: nảy ra ý tưởng
launching a website: chạy một trang web
set a goal: đặt mục tiêu
raise the heart rate: tăng nhịp tim
lift the spirit: nâng cao tinh thần
physical strength: sức mạnh thể chất
collaborate with\cooperate with\work and exchange idea with: hợp tác
in place(idiom) tại chỗ|running in place
medical practice()trung tâm y tế
extra charge()phí phụ thêm
this offer()đề nghị này
take advantage of()tận dụng lợi thế
make an appointment()sắp xếp một cuộc hẹn
blood drive()đợt hiến máu
than usual()hơn thường lệ
drop by()ghé ngang qua
application deadline()thời hạn nộp đơn xin việc/xin phép
look closely()nhìn kỹ
board of education()hội đồng giáo dục
pay off(phrasal verb)thành công
sort of(idiom)khá là
show up(phrasal verb)xuất hiện|she finally showed up.
smoke detector(n)thiết bị báo cháy
by the time()vào lúc|by the time I call
excused from()miễn|board member excused from the meeting'miễn họp)
advise against()khuyên không nên|I would advise against answering question
gas oven(ˈʌvn)bếp ga
fridge freezer(n - frɪdʒ)tủ lạnh
master bathroom()phòng tắm chính
problem free()không có vấn đề gì
senior citizen()người cao tuổi
risk her life()liều mạng
few thought: ít ai nghĩ
rushed up: lao vào
taken away(phrasal verb) mang đi|Two burgers to take away, please.
general admission: sơ tuyển
as long as: miễn là
in order that: để
as 'if\though'(idiom) như thể
on the other hand(idiom) mặt khác
breakroom()phòng nghỉ