# Khóa 4 test 3 TOEIC mỗi ngày
1. Slovington Charity Goft Tournament: Giải golf từ thiện Solvington
2. Out of all of next year's target: trong số tất cả mục tiêu năm tới
3. Please remind all staff memebers that parking permits must be visible displayed on parked vehicles at all times: Vui lòng nhắc nhở tất cả nhân viên rằng giấy phép lái xe phải luôn được hiển thị rõ ràng trên các phương tiện đang đỗ
4. A recent journal article indicates that conducting on-the-job training repeatedlly help to keep employee productive and alert: Một bài báo gần đây chỉ ra rằng việc thực hiện đào tạo tại chỗ giúp giữ cho nhân viên làm việc hiệu quả và tỉnh táo
5. With regret, ... : rất tiếc, ...
7. Digital Digest Magazine has awarded its highest rating in technical performance to the Mobium 6 smart phone: Tạp chí Digital Digest đã thưởng đánh giá cao nhất của họ về hiệu suất kỹ thuật cho điện thoại mobium 6
8. The CEO is reluctant to slow down production, ... : CEO bất đắc dĩ sản xuất chậm lại ...
9. Cooking wider range of dishes: nấu nhiều món ăn hơn
10. They range from simple whitecakes to multi-color with flowers: chúng bao gồm từ chiếc bánh đơn giản đến ...
11. This range of mechandise has now been finalized: dòng sản phẩm này bây giờ đã được hoàn thiện
12. Speaking to reporter: phát biểu với các phóng viên
13. The firm will be successful in competing with rival sporting attire manufacturer Speedgrab in these regions: Hãng sẽ thành công trong việc cạnh tranh với đối thủ là nhà máy sản xuất trang phục thể thao Speedgrab ở những khu vực này
14. Walsh went on to declare that he will relocate to Germany to personally oversee the transition: Walsh tiếp tục tuyên bố rằng ông ta sẽ chuyển tới Đức để đích thân giám sát quá trình chuyển đổi
15. A hub for sustainable energy technology, will make its considerable resrouces available to Orgami: Sẽ "tạo ra" nguồn lực đáng kể cho Orgami
16. just across the road from the Odoner theater: chỉ ngay đối diện/ngay bên kia đường/băng qua đường  từ nhà hát Odoner
17. we promised seven-day shipping: vận chuyển trong bảy ngày
18. newspaper articles: bài báo
19. I was due to give the sales presentations: tôi đã định thuyết trình bán hàng
20. Lee's Dry Cleaner has enjoyed serving the community of Bambrigde: Lee's Dry Clear rất vui khi được phục vụ cộng đồng Bambridge
21. Pruduct Manager: giảm đốc sảm phẩm
22. Product line: dòng sản phẩm
23. a new line of kitchen applicances to be launched this fall: dòng thiết bị nhà bếp mới ra mắt vào mùa thu này
24. As such, serveral traning workshops will be held: do đó, ...
25. the overtime rate: tỉ lệ làm thêm giờ
26. autograph signing: ký tặng
27. With support band The Institution opening the performance: với sự hỗ trợ của ban nhạc Institution mở màn buổi biểu diễn
28. The authors' humorous approach combined with his gift of words made Overcoming the odds a great read: Cách tiếp cận hài hước của tác giả kết hợp với năng khiếu ngôn từ của ông đã khiến Vượt qua tỷ lệ trở thành một tác phẩm tuyệt vời.
29. he signed a book deal: ký hợp đồng viết sách
30. government-run by Symon City: được điều hành bởi thành phố Symon

# End of khóa 4 test 3 TOEIC mỗi ngày
31. head of maintenance: người đứng đầu việc bảo trì
32. for your convenience: để thuận tiện cho bạn
33. we'll be heading to the security center later today: đến trung tâm bảo mật vào cuối ngày hôm nay
34. she has practiced law for more than 10 years: hành nghề luật
35. DG Feed Supply has shown strong growth: cho thấy sự tăng trưởng mạnh
36. attendee said that ...: người tham dự cho rằng
37. he held a variety of senior management roles across public and private sectors: ông giữ nhiều vai trò quản lý cấp cao trong các lĩnh vực công và tư
38. Please allow up to five business day: vui lòng đợi tối đa 5 ngày làm việc
39. I will have limited Internet access: tôi sẽ bị hạn chế truy cập internet
40. while there, we put together: trong khi đó, chúng tôi kết hợp với nhau
41. The candidate should possess a range of relevant knowledge: ứng viên cần sở hữu nhiều kiến thức thích hợp
42. I am aware that your greenhouses are located some distance from one another: t biết rằng nhà kính của bạn nằm cách xa nhau
43. Ms. Fadulu holds a degree in journalism: Cô fadulu có bằng báo chí
44. Student artists will be on hand: nghệ sĩ sinh viên sẽ có mặt
45. work for the amount of $2,650 plus tax: công việc với số tiền 2650$ cộng với thuế
46. Do not come in over the weekend: đừng đến vào cuối tuần
47. On top of that, the food was delicious: hơn hết, ....
48. what do the training have in common?: ... có điểm gì chung?
49. State Route: quốc lộ
50. that make sense: có lý
51. a concert hall: phòng hòa nhạc
52. a shuttle ride: chuyến xe đưa đón
53. I can't finish entering him into our system: tôi không thể hoàn thành việc nhập anh ta vào hệ thống
54. at your earliest convenience: lúc mà thuận tiện nhất sớm nhất cho bạn
55. getting the minimum grades: đạt được điểm tối thiểu
56. He is about to attend a meeting: anh ta sắp tham gia một cuộc họp
57. It's only 2 weeks away: chỉ còn 2 tuần
58. It's twenty dollars to take a taxi: đó là 20 đô để bắt taxi.
59. funeral home: nhà tang lễ
60. top of the range: hàng đầu | the new smartphone is top of the range, offering the latest technology and features
61. swing shift jobs: công việc xoay ca | many employees prefer swing shift jobs 
62. in writing: bằng văn bản | the agreement must be in writing to ensure clarity
63. in turn: lần lượt | during the meeting, each team member will present their findings in turn.
64. places an order: đặt hàng | the company regularty places orders tiwh its suppliers
65. take order: nhận hàng | part of my job is to take orders from customers
66. I'd rather do sth: tôi muốn …. | I’d rather work on this project alone to ensure it meets my standards
67. stopping by: ghé qua | while driving home, I’m planning on stopping by the grocery store to pick up some essentials
68. board of directors: ban giám đốc
69. production capabilitis: khả năng sản xuất | The company’s productin capabilities have increased significantly with the recent upgrades.
70. product in demand: sản phẩm có nhu cầu | meet the demands of consumers for products in demand
71. drop by: ghé qua | feel free to drop by for a cup of coffee
72. take note: ghi chú | be sure to take note of the key points
73. make a difference: làm  nên sự khác biệt | small changes in our daily habits can make a significant difference to the environment
74. variety of: Nhiều, đa dạng | the store offers a variety of options to cater (phục vụ) to different customers preferences.
75. close to return: sắp trở lại | the team is close to returning to the championship 
76. check into: đăng ký/nhận phòng | guest are required to check into the hotel at the front desk
77. Academy Award: Giải thưởng viện Hàn lâm/ giải Oscar
78. pay increase (cụm n): mức tăng lương | the employees are requesting a pay increase
79. lost and found area: khu vực hành lý thất lạc | If you’ve lost something, please check the lost and found area near the main entrance
80. set out: khởi hành | they set ou on their journey early in the morning to avoid traffic
81. suffer from (v): chịu đựng 1 cái gì đó |many people suffer from allergies (dị ứng) 
82. twice as … as: gấp đôi | the new smartphone is twice as powerful as its predecessor (tiền nhiệm)
83. medical attention: chăm sóc y tế | seek medical attention if you experience persistent symtoms or discomfort
84. a concert violenist: nghệ sĩ hòa tấu violin
85. Peace Corps: tổ chức hòa bình | The Peace Corps is an organization dedicated to promoting peace worldwide
86. Medal for Valor: huân chương cho người dũng cảm | He received the Medal of Valor
