forklift: xe nâng
silverware: đồ dùng bằng bạc
detour: đi đường vòng
storage compartment: khoang chứa đồ
the front bumper: tấm chắn trước xe
chauffeur: tài xế
bookkeeping: kiểm toán
prep: chuẩn bị
passionately: đam mê
devoted: tận tụy
engine vacuum defect: lỗi động cơ
chauffeur(n - ˈʃəʊfər)lái xe|the chauffeur drove us to the event
meteorologist(n - ˌmiːtiəˈrɒlədʒɪst)nhà khí tượng học|the meteorologist predicted a storm

### Test 08th
pull over: tấp vào lề
adversely: xấu
the polls were favoring senatiorial candidate Natasha: các cuộc thăm dò đang ủng hộ ứng viên thượng nghị sĩ
foreman: quản đốc
this will be done in the recognition of the public holidy: công nhận ngày lễ cộng đồng
conductor: người kiểm soát
fabrication: chế tạo
pebbles or decorative gravel: đá cuội hoặc ỏi trang trí
submerged: ngâm trong nước
soak: ngâm
procure: lấy từ
antique: cổ
action-packed scenes: cảnh hành động
though-provoking dialog: đoạn hội thoại kích thích tư duy
newsworthy: đáng chủ ý
mattress: nệm cao su
memory foam: than hoạt tính
soak up: thấm, ngấm
sweat: mồ hôi

### Test 09th
flowerbed: vườn hoa
lawn clipping and other debris: cỏ cắt ra và mảnh vụn
testimonral: lời chứng thực
contamination: ô nhiễm
meticulously: cẩn thận
matiness: buổi biểu diễn
obedience: vâng lời
competenly: hiệu quả
seniority: thâm niên
floral centerpieces: lọ hoa
checkered: ô vuông
crystal light fixture: đèn pha lê

### Test 10th
assort?
shallow sunken garden: khu vườn có ao nước nông, khu vườn trũng nông
drainage: hệ thống thoát nước
overtighten: siết chặt quá
cushion: lớp đệm
sweeping: sâu rộng
cathedral ceiling: mái nhà vòm
revolutionize: cách mạng
vetted: được kiểm định
sparking clean: sạch bóng
upward and global mobility: khả năng thăng tiến
ordeal: thử thách
train-freight: vận tải đường sắt
veteran: kỳ cựu
infusion: sự pha trộn
laid-back: thoải mái
aromatic jewel amid the bustling shops and eateries in Wester Square: một viên ngọc thơm giữa các cửa hàng và quá ăn nhộn nhịp ở quảng trường Wester
marinate: ướp
stew: hầm
cabbage: bắp cải
glowing: khen ngợi
underred: không nản lòng
paving stone: đá lát
archaeologist: nhà khảo cổ học
intricate: phức tạp
mosaics: các bức tranh khảm

### test 11th
cabinetmaker: thợ đóng tủ
woodworking: chế biến gỗ
three demographic: 3 nhóm đặc điểm
sensations: cảm giác
inadventently
betterment: sự phát triển
backed up: làm chậm trễ
this is cost-effective means: phương tiện hiệu quả về mặt chi phí
emblem: biểu tượng
fabric tote bags: túi vải
solicit: thu thập
seafaring(adj - ˈsiːˌfɛrɪŋ)hàng hải|he comes from a seafaring family
boutique hotel: loại khách sạn nhỏ, có phong cách riêng
doorstep: trước cửa

### test 12th
smothered: phủ
thin crust pizza: pizza vỏ mỏng
diner: khách ăn uống
redeem: đổi
inning: lượt
a meterial that is 15% stronger: vật liệu bền hơn 15%
pal: người bạn
palatability: sự dễ chịu
outreach: tiếp cận
Chicago native Sofia Carla: Sofia Carla, người gốc Chicago 
Fine Arts: mỹ thuật
Peruvian: người Peru
MS: Master Science | thạc sỹ 
MBA: Master Business Administration | thạc sỹ quản trị kinh doanh
tidbits of advice: lời khuyên
picturesque: đẹp như tranh
Dutch: Hà Lan
wetland: vùng ngập nước
flower bed: luống hoa
quaint: cổ kính


### test 13th
originality: tính độc đáo
circulation: lưu thông
parliament: quốc hội
cubicles: phòng làm việc
commemorate: kỷ niệm
return cutoff date: ngày hết hạn trả hàng
cardboard shoulder guards: móc treo bằng bìa các tông
off-limits: bị cấm
mini bale of straw: kiện rơm nhỏ
nurturing: nuôi dưỡng
recuperation: phục hội
drape: màn cửa
for the sake of (idiom) vì lợi ích của
retractable roof: mái che có thể thu vào
majestic: hùng vĩ
military outpost: đồn quân sự
meticulously manicured garden: khu vườn được cắt tỉa cẩn thận
sampling examples of medivals cusine: thưởng thức các món ăn thời trung cổ
occcurrence: sự kiện
runway: sàn diễn
the most flattering fit: vừa vặn nhất
stethoscope: ống nghe
literacy: xóa mù chữ
chapel: nhà cầu nguyện
want to see it in action: thấy nó hoạt động
facing forward: hướng về phía trước
the leather strap and the sleek design: dây đeo bằng da và thiết kế đẹp mắt
hang on to = keep: giữ lại
clearance: thanh lý
the road look clear: có vẻ thông thoáng
icebreaker: a thing that you do or say, such as a game or a joke, to make people feel more relaxed, especially at the beginning of a meeting, party, etc.
the finishing touche (n - ˈfɪnɪʃɪŋ ˈtʌʧɪz): bước hoàn thiện | She’s putting the finishing touches on the report.

### test 14th
the chiller enclosure: vỏ máy lạnh
untangled: gỡ rối
breeders: người lai tạo
cater: hướng dẫn
fusion cooking: nấu ăn kết hợp
flair: sự tinh tế
inflate: bơm lốp
tread: gai lốp xe
a flat tire: lốp xe bị thủng
audiovisual: nghe nhìn
well-wisher: người chúc mừng
attested: chứng nhận
honoree: người được tôn vinh
professionalism: sự chuyên nghiệp
judgmental: phán đoán
accomplished: tài năng
trademark (n - ˈtreɪdmɑːrk) đăng ký
composition (n - ˌkɑːmpəˈzɪʃn) tác phẩm | The composition of the music piece was brilliant
a steel cover (n - ə stiːl ˈkʌvər) tấm thép | The door was protected by a steel cover
