28
23
cooperate(v - kəʊˈɑːpəreɪt)hợp tác
aid(n - eɪd)viện trợ, cấp cứu
depress(v - dɪˈpres)trầm cảm
despite(prep - dɪˈspaɪt)mặc dù
abuse(n - əˈbjuːs)lạm dụng
reputation(n - ˌrepjuˈteɪʃn)uy tín
persuade(v - pərˈsweɪd)thuyết phục
occupation(n - ˌɑːkjuˈpeɪʃn)nghề nghiệp
relieve(v - rɪˈliːv)giảm đau
bush(n - bʊʃ)bụi cây
definite(adj - ˈdefɪnət)chắc chắn, xác định
broad(adj - brɔːd)rộng lớn, rộng
candle(n - ˈkændl)nến
sue(v - suː)kiện
fault(n - fɔːlt)sai lầm, lỗi
edge(n - edʒ)mép
slave(n - sleɪv)nô lệ
colleague(n - ˈkɑːliːɡ)đồng nghiệp
violent(adj - ˈvaɪələnt)hung bạo
principal(adj - ˈprɪnsəpl)hiệu trưởng
plenty(pro - ˈplenti)nhiều
convey(v - kənˈveɪ)truyền
metal(n - ˈmetl)kim loại
fog(n fɑːɡ)sương mù
genius(n - ˈdʒiːniəs)thiên tài
income(n - ˈɪnkʌm)thu nhập
confident(adj - kɑːnfɪdənt)tự tin
convert(v - kənˈvɜːrt)chuyển đổi
afford(v - əˈfɔːrd)mua được, đủ khả năng
enormous(adj - ɪˈnɔːrməs)khổng lồ
citizen(n - ˈsɪtɪzn)người dân, cư dân
overseas(adj - ˌəʊvərˈsiːz)hải ngoại, nước ngoài
impression(n - ɪmˈpreʃn)ấn tượng
volcano(n - vɑːlˈkeɪnəʊ)núi lửa
significant(adj - sɪɡˈnɪfɪkənt)có ý nghĩa, quan trọng
enable(v - ɪˈneɪbl)cho phép
admire(v - ədˈmaɪər)ngưỡng mộ
colony(n - ˈkɑːləni)thuộc địa
cage(n - keɪdʒ)lồng
reveal(v - rɪˈviːl)tiết lộ
nevertheless(adv - ˌnevərðəˈles)tuy nhiên
astronomy(n - əˈstrɑːnəmi)thiên văn học
capable of(adj - ˈkeɪpəbl)có khả năng
mad(adj - mæd)điên
extraordinary(adj - ɪkˈstrɔːrdəneri)phi thường
sword(n - sɔːrd)thanh kiếm
basis(n - ˈbeɪsɪs)nền tảng
resist/ struggle(v - rɪˈzɪst, ˈstrʌɡl)chống lại, đấu tranh
biology(n - baɪˈɑːlədʒi)sinh học
cheat(v - tʃiːt)gian lận
guarantee(v - ˌɡærənˈtiː)đảm bảo
committee(n - kəˈmɪti)ủy ban
rely(v - rɪˈlaɪ)dựa vào
obvious(adj - ˈɑːbviəs)hiển nhiên
mechanic(n - məˈkænɪk)thợ cơ khí, thợ máy
elevate(v - ˈelɪveɪt)nâng lên
criticize(v - ˈkrɪtɪsaɪz)chỉ trích, phê bình
rational(adj - ˈræʃnəl)hợp lý
consult(v - kənˈsʌlt)tham khảo ý kiến
stare(v - ster)nhìn chằm chằm
faith (n - feɪθ) lòng tin, tin tưởng | she has faith in her team's abilities
fortune(n - ˈfɔːrtʃən)vận may
expense(n - ɪkˈspens)chi phí
remind(v - rɪˈmaɪnd)nhắc
signal(n - ˈsɪɡnəl)tín hiệu
unique(adj - juˈniːk)độc nhất, độc đáo
priest(n - priːst)thầy tu
portion(n - priːst)một phần
flu(n - fluː)cúm
shy(adj - ʃaɪ)ngại
prime(adj - praɪm)nguyên tố
joy(n - dʒɔɪ)thích, vui sướng 
vision(n - ˈvɪʒn)tầm nhìn
pride(n - praɪd)tự hào
anxiety(n - æŋˈzaɪəti)lo lắng
soil(n - sɔɪl)đất
diary(n - ˈdaɪəri)nhật ký
likeness(n - ˈlaɪknəs)giống nhau
interrupt(v - ˌɪntəˈrʌpt)làm gián đoạn, gián đoạn
deny(v - dɪˈnaɪ)từ chối
element(n - ˈelɪmənt)yếu tố
odd(adj - ɑːd)kỳ cục
chamber(n - ˈtʃeɪmbər)buồng
dig(v - dɪɡ)đào
fever(n - ˈfiːvər)sốt
flaver(n - ˈfleɪvər)hương vị
dine(v - daɪn)ăn trưa
ceiling(n - ˈsiːlɪŋ)trần nhà
shift(n - ʃɪft)ca, đổi
attach(v - əˈtætʃ)buộc
generation(n - ˌdʒenəˈreɪʃn)thế hệ, tạo ra
greet(v - ɡriːt)chào
potential(adj - pəˈtenʃl)tiềm năng, khả năng, tiềm tàng
recover(n - rɪˈkʌvəri)bình phục, phục hồi
agriculture(n - ˈæɡrɪkʌltʃər)nông nghiệp
ability(n əˈbɪləti)khả năng
ignore(v - ɪɡˈnɔːr)bỏ qua
calculate(v - ˈkælkjuleɪt)tính toán
junior(adj - ˈdʒuːniər)tập sự, sơ cấp
mud(n - mʌd)bùn
sincere(adj - sɪnˈsɪr)chân thành
initial(adj - ɪˈnɪʃl)ban đầu
proof(n - pruːf)bằng chứng
commit(v - kəˈmɪt)cam kết
thesis(n - ˈθiːsɪs)luận án
lend(v - lend)cho vay
curious(adj - ˈkjʊriəs)hiếu kỳ
formal(adj - ˈfɔːrml)trang trọng
end(file)
