0
dress code: quy định trang phục
alighment: căn chỉnh
tailor: thợ may
costume: trang phục
booket: tập, tập sách
soil: đất
pollutant: chất ô nhiễm
stram: suối
acquire: có được
professional (n): chuyên gia
professional (adj): chuyên nghiệp
we take pride ...: chúng tôi tự hào
indeed: thật vậy
sustantial: đáng kể
opening: vị trí có sẵn, công việc có sẵn
expedite: đẩy nhanh
give home cooks: mang đến cho người nấu ăn tại nhà
heritage: di sản
blend: hòa trộn
it takes diner reservation: nó nhận đặt chỗ bữa tối
nearby: gần đó
profiled: được giới thiệu
appetiser: món khai vị
scattered: rải rác
sweep: lau
blender: máy xay
prescription: đơn thuốc
sweater: áo len
authorize: cho phép
deck: bong tàu
hospitality: khách sạn
concentrate: tập trung
napkin: khăn ăn
dealership: đại lý
loose: lỏng
habitant: cư dân
trail: đường mòn