10
34
flip(v - flɪp)cú lộn nhào					A back flip: cú nhào lộn ra phía sau
imitate(v - ˈɪmɪteɪt)bắt chước				Teachers provide a model for children to imitate.
somewhat(v - ˈsʌmwʌt)phần nào				I was somewhat surprised to see him.
fossil(n - ˈfɑːsl)hóa thạch					fossils over two million years old
cliff(n - klɪf)vách đá						the cliff edge (mép)
childbearing(n - ˈtʃaɪldberɪŋ)sinh đẻ		women of childbearing age
rearing(n - ˈrɪrɪŋ)nuôi dạy
certainty(n - ˈsɜːrtnti)sự chắc chắn		Her return to the team now seems a certainty.
confusing(adj - kənˈfjuːzɪŋ)khó hiểu		a confusing situation/experience
unsatisfactory(adj - ˌʌnˌsætɪsˈfæktəri)không đạt yêu cầu
litter(n - ˈlɪtər)xả rác
carelessly(adv - ˈkerləsli)bất cẩn
sibling(n - ˈsɪblɪŋ)anh chị em ruột			but they wanted her to have siblings
septuplet(n - sepˈtuːplət)sinh bảy
generous(adj - ˈdʒenərəs)hào phóng
stimulating(adj - ˈstɪmjuleɪtɪŋ)thú vị
virtually(adv - ˈvɜːrtʃuəli)hầu hết			Work (công việc) influences virtually (hầu hết) every aspect of your life
solitary(adj - ˈsɑːləteri)đơn độc
aerospace(n - ˈerəʊspeɪs)hàng không vũ trụ
commision(n - kəˈmɪʃn)hoa hồng
merit(n - ˈmerɪt)điểm tốt
demerit(n - diːˈmerɪt)điểm kém
grueling(adj - ˈɡruːəlɪŋ)mệt mỏi
mature(adj - məˈtʃʊr)trưởng thành
pave(v - peɪv)mở đường
applicant(n - ˈæplɪkənt)người nộp đơn
need(n - niːd)nhu cầu
state(n - steɪt)tuyên bố, nêu
intuition(n - ˌɪntuˈɪʃn)trực giác
formulate(v - ˈfɔːrmjuleɪt)hình thành
maneuver(n - məˈnuːvər)diễn tập
vaguely(adv - ˈveɪɡli)mơ hồ
rather(adv - ˈræðər)thay vào đó
interrelated(adj - ˌɪntərɪˈleɪtɪd)liên quan
ambiguity(n - ˌæmbɪˈɡjuːəti)sự mơ hồ
inconsistency(n - ˌɪnkənˈsɪstənsi)không nhất quán
novelty(n - ˈnɑːvlti)mới lạ
course(n - kɔːrs)quá trình				course of action
subconscious(adj - ˌsʌbˈkɑːnʃəs)tiềm thức			
derivation(n - ˌderɪˈveɪʃn)dẫn xuất				a result a lengthy chain of logical 'derivations'. (dẫn xuất logic) 
writer(n - ˈraɪtər)nhà văn
downsizing(n - ˈdaʊnsaɪzɪŋ)cắt giảm
secure(adj - sɪˈkjʊr)an toàn
grant(n - ɡrænt)khoản tài trợ
cognitive(adj - ˈkɑːɡnətɪv)nhận thức
spectacular(adj - spekˈtækjələr)ngoạn mục, đẹp mắt
lift(v - lɪft)quá giang 					~ i got a lift from friends
fiber(n - ˈfaɪbər)chất xơ
buddy(n - ˈbʌdi)đứa bạn
probing(adj - ˈprəʊbɪŋ)thăm dò, mang tính thăm dò
arbitrary(adj - ˈɑːrbɪtreri)tùy tiện
irrational(adj - ɪˈræʃənl)phi lý
grasp(v - ɡræsp)sự hiểu biết
capriciousness(n - kəˈprɪʃəsnəs)sự thất thường
painstaking(adj - ˈpeɪnzteɪkɪŋ)chăm chỉ				based on years of painstaking practice 
executive(n - ɪɡˈzekjətɪv)giám đốc điều hành
hands-on(adj - ˌhændz ˈɑːn)thực tế					hands-on experience 
integrate, synthesize(v - ˈɪntɪɡreɪt, ˈsɪnθəsaɪz)tổng hợp			to synthesize isolated bits of data 
isolated(adj - ˈaɪsəleɪtɪd)bị cô lập
systematic(adj - ˌsɪstəˈmætɪk)có hệ thống			such systematic methods
occasionally(adv - əˈkeɪʒnəli)đôi khi
leery(adj - ˈlɪri)tinh ranh
bypass(n - ˈbaɪpæs)bỏ qua
plausible(adj - ˈplɔːzəbl)có vẻ hợp lý
engender(v - ɪnˈdʒendər)đưa đến
instantaneous(adj - ˌɪnstənˈteɪniəs)tức thời
instigate(v - ˈɪnstɪɡeɪt)bắt đầu
cite(v - saɪt)trích dẫn
refutation(n - ˌrefjuˈteɪʃn)bác bỏ
viewpoint(n - ˈvjuːpɔɪnt)quan điểm
instinctively(adv - ɪnˈstɪŋktɪvli)theo bản năng
virgin(n - ˈvɜːrdʒɪn)trinh nữ
sacrifice(n - ˈsækrɪfaɪs)sự hy sinh			is thought of as the greatest sacrifice that a father can make 
groom(n - ɡruːm)chú rể
perpetuate(v - pərˈpetʃueɪt)duy trì				as an obligation to perpetuate his bloodline. 
divorce(n - dɪˈvɔːrs)ly hôn
medieval(adj - ˌmiːdˈiːvl)thời trung cổ
polygamy(n - pəˈlɪɡəmi)đa thê
Muslim(adj - ˈmʊslɪm)đạo hồi
compulsory(adj - kəmˈpʌlsəri)bắt buộc
minor(n - ˈmaɪnər)chưa thành niên
negotiation(n - nɪˌɡəʊʃiˈeɪʃn)đàm phán
dowry(n - ˈdaʊri)của hồi môn
astrologer(n - əˈstrɑːlədʒər)nhà chiêm tinh
turmeric(n - ˈtɜːrmərɪk)nghệ
garland(n - ˈɡɑːrlənd)vòng hoa
symbolic(adj - sɪmˈbɑːlɪk)tượng trưng
obligation(n - ˌɑːblɪˈɡeɪʃn)nghĩa vụ
tease(v - tiːz)trêu ghẹo
institution(n - ˌɪnstɪˈtuːʃn)tổ chức
vow(n - vaʊ)lời thề
guardian(n - ˈɡɑːrdiən)người giám hộ
real estate agent(n - ˈriːəl ɪsteɪt eɪdʒənt)đại lý bất động sản
elaboration(n - ɪˌlæbəˈreɪʃn)công phu
end(file)