## test 6th, map vưới phrase_08
10
form of identification (n - fɔːrm əv aɪˌdentɪfɪˈkeɪʃn) hình thức nhận dạng | please provide a valid form of identification
unhelpful (adj - ʌnˈhelpfəl) vô ích | his comments were unhelpful
credit (n - ˈkrɛdɪt) tín nhiệm | she has earned credit for her hard work
a fitness instructor (n - ə ˈfɪtnəs ɪnˈstrʌktər) huấn luyện viên thể dục/thể hình | she is a certified fitness instructor
mark (v - mɑːrk) đánh dấu | mark the correct answer
consequence (n - ˈkɒnsɪkwəns) hậu quả | every action has a consequence
salespeople (n - ˈseɪlzˌpiːpl) nhân viên bán hàng | the salespeople are very helpful
artist (n - ˈɑːrtɪst) nghệ sĩ | she is a talented artist
produce (v - prəˈduːs) sản xuất | they produce high-quality goods
produce (n - ˈprɒdjuːs) sản phẩm | fresh produce is available at the market
transport (v - trænsˈpɔːrt) chuyển/vận chuyển | they transport goods across the country
fall (v - fɔːl) rơi, giảm | the prices fall during the sale
alternate (adj - ˈɔːltərnət) thay thế | alternate routes are available
objection (n - əbˈdʒekʃn) sự phản đối | there was an objection to the proposal
collective (adj - kəˈlektɪv) tập thể | it was a collective effort
cooperative (adj - koʊˈɒpərətɪv) hợp tác | they have a cooperative relationship
flavors (n - ˈfleɪvərz) hương vị | the dish has a variety of flavors
catch on (phrasal verb - kætʃ ɒn) bắt kịp | the new trend is starting to catch on
settle (v - ˈsetl) giải quyết | they settled their differences
neighbourhood (n - ˈneɪbərˌhʊd) khu phố, khu vực lân cận | the neighbourhood is very friendly
employee badge (n - ɪmˈplɔɪi bædʒ) thẻ nhân viên | she wore 'đeo' her employee badge
authorize (v - ˈɔːθəraɪz) ủy quyền | she authorized the payment
vacancy (n - ˈveɪkənsi) tuyển dụng | there is a vacancy for a manager
experience is preferred (phrase - ɪkˈspɪəriəns ɪz prɪˈfɜːrd) ưu tiên có kinh nghiệm | experience is preferred for this position
cafeteria (n - ˌkæfəˈtɪriə) quán ăn | they had lunch in the cafeteria
At that point (phrase - æt ðæt pɔɪnt) khi đó | at that point, it was too late
a sales associate (n - ə seɪlz əˈsoʊʃiət) nhân viên bán hàng | she is a sales associate at the store
panel of judges (n - ˈpænəl əv ˈdʒʌdʒɪz) ban giám khảo | the panel of judges will decide the winner
garner (v - ˈɡɑːrnərd) thu hút | her performance garnered praise
representation of client (phrase - ˌrɛprɪˈzɛnˌteɪʃən əv ˈklaɪənt) đại diện cho khách hàng | he specializes in representation of clients
profile (v - ˈproʊfaɪl) giới thiệu | the magazine will profile the artist
advertiser (n - ˈædvərˌtaɪzər) nhà quảng cáo | the advertiser created a compelling ad
fit (v - fɪt) phù hợp | the shoes fit perfectly
Effective June 15 (phrase - ɪˈfɛktɪv dʒuːn fɪfˈtiːn) có hiệu lực từ 15/6 | the policy is effective June 15
excessive (adj - ɪkˈsɛsɪv) quá mức | the noise was excessive
security officers (n - sɪˈkjʊrɪti ˈɒfɪsərz) nhân viên an ninh | the security officers are on duty
courteous (adj - ˈkɜːrtiəs) lịch sự | the staff is always courteous
it is relatively inexpensive () nó tương đối rẻ | it is relatively inexpensive compared to others
dinner plates (n - ˈdɪnər pleɪts) đĩa ăn tối | the dinner plates are on sale
pale blue (adj - peɪl bluː) xanh nhạt | the room was painted a pale blue
water goblet (n - ˈwɔːtər ˈɡɒblɪts) cốc nước | the set includes water goblets '1 loại cốc nước'
shipping carriers (n - ˈʃɪpɪŋ ˈkærɪərz) nhà vận chuyển | they use reliable shipping carriers
regardless (adv - rɪˈɡɑːrdlɪs) dù sao đi nữa | they continued regardless of the weather
amend (v - əˈmend) sửa chữa | they amended the contract
table linen (n - ˈteɪbl ˈlɪnɪn) khăn trải bàn | the table linen is elegant 'thanh lịch'
ordinance (n - ˈɔːrdɪnəns) quy định | the city passed 'thông qua' a new ordinance
tight budget (n - taɪt ˈbʌdʒɪt) ngân sách hạn chế | they are working with a tight budget
the charge (n - ðə tʃɑːrdʒ) việc tính phí, khoản phí | the charge is reasonable
In brief (phrase - ɪn briːf) tóm tắt | in brief, the meeting was a success
ground (n - ɡraʊnd) đất đai | the ground is fertile
clerical(adj - ˈklerɪkl) văn thư | clerical workers/staff
give me a lift (phrase - ɡɪv miː ə lɪft) cho tôi đi cùng | can you give me a lift to the station?
frozen-goods (n - ˈfroʊzən ɡʊdz) thực phẩm đông lạnh | the frozen-goods section is in aisle 5
handbag (n - ˈhændˌbæɡ) túi xách tay | she bought a new handbag
a garment bag (n - ə ˈɡɑːrmənt bæg) túi đựng quần áo | he packed his suit in a garment bag
wheelbarrow (n - ˈwiːlˌbæroʊ) xe rùa, xe cút kít | he used a wheelbarrow to move the soil
let's walk to the back of the train (phrase) đi xuống cuối tàu | let's walk to the back of the train
oven (n - ˈʌvən) lò vi sóng | preheat 'làm nóng' the oven to 180 degrees
catch (v - kɔːt) phát hiện | he was caught stealing
reimbursement (n - ˌriːɪmˈbɜːrs) khoản hoàn trả | You will receive reimbursement
meeting minutes (n - ˈmiːtɪŋ ˈmɪnɪts) tóm tắt cuộc họp | the meeting minutes are available online
pamphlet (n - ˈpæmflət) tờ rơi quảng cáo | the pamphlet provides information about the event
tour (v - tʊər) tham quan | they toured the city
represent (v - ˌrɛprɪˈzɛnt) đại diện | she represents the company in negotiations 'trong đàm phán'
funding (n - ˈfʌndɪŋ) kinh phí, nguồn tài trợ | it relies on advertisements for funding 'có kinh phí'
advanced (adj - ədˈvænst) tiên tiến | working on advanced technology
coat: áo khoác
stairway: cầu thang
noon: trưa
resurface: cải tạo lại