20
22
replace(v - rɪˈpleɪs)thay thế
emphasize(v - ˈemfəsaɪz)nhấn mạnh
braket(n - ˈbrækɪt)dấu ngoặc
lead(v - liːd)dẫn đầu
examine(v - ɪɡˈzæmɪn)xem xét
certainly(adv - ˈsɜːrtnli)chắc chắn
cheerful(adj - ˈtʃɪrfl)vui vẻ
pull(v - pʊl)kéo
foundation(n - faʊnˈdeɪʃn/ 4)tổ chức
somehow(adv - ˈsʌmhaʊ)bằng cách nào đó
unforgettable(adj - ˌʌnfərˈɡetəbl)không thể nào quên
ceremony(n - ˈserəməʊni)lễ, buổi lễ
tend(v - tend)có xu hướng
customs(n - ˈkʌstəmz)hải quan
blossom(n - ˈblɑːsəm)nở hoa
skid(v - skɪd)trượt
ditch(n - dɪtʃ)mương
reference(n - ˈrefrəns)đề cập
robbery(n - ˈrɑːbəri)vụ cướp
unusual(adj - ʌnˈjuːʒəl)bất thường
foresee(v - fɔːrˈsiː)thấy trước
purse(n - pɜːrs)ví
valuable(adj - ˈvæljuəbl)có giá trị
relatively(adv - ˈrelətɪvli)tương đối
burglary(n - ˈbɜːrɡləri)vụ trộm
break(v - breɪk)phá vỡ
apologise(v - əˈpɑːlədʒaɪz)xin lỗi
lay(v - leɪ)đặt nằm
workplace(n - ˈwɜːrkpleɪs)nơi làm việc
essential(adj - ɪˈsenʃl so`)thiết yếu
dramatically(adv - drəˈmætɪkli)đột ngột
whether(conj - ˈweðər)liệu
frightening(adj - ˈfraɪtnɪŋ)đáng sợ
flat(n - flæt)phẳng
postal(adj - ˈpəʊstl)bưu chính
empty(v - ˈempti)làm trống
generally(adv - ˈdʒenrəli)thường xuyên, nói chung, chung, thường
particular(adj - pərˈtɪkjələr)đặc biệt, cụ thể
enthusiasm(n - ɪnˈθuːziæzəm)nhiệt tình
thoroughly(adv - ˈθɜːrəli)hoàn toàn, kỹ lưỡng
negative(adj - ˈneɡətɪv)tiêu cực
eventually(adv - ɪˈventʃuəli)cuối cùng
investigate(v - ɪnˈvestɪɡeɪt)điều tra
intense(adj - ɪnˈtens)dữ dội, căng thẳng
dormitory(n - ˈdɔːrmətɔːri)ký túc xá
intent(n - ɪnˈtent)ý định
grain(n - ɡreɪn)ngũ cốc
remark(n - rɪˈmɑːrk)nhận xét
hardly(adj - ˈhɑːrdli)khó khăn
protest(n - ˈprəʊtest)chống lại
sculpture(n - ˈskʌlptʃər)điêu khắc
disadvantage(v - ˌdɪsədˈvæntɪdʒ)bất lợi
carve(v - kɑːrv)cắt
severe(adj - sɪˈvɪr)nghiêm trọng
chest(n - tʃest)ngực
seek(v - siːk)tìm kiếm
lift(v - lɪft)nâng, nâng lên
brief(adj - briːf)ngắn
secretary(n - ˈsekrəteri/ 4)thư ký
blind(adj - blaɪnd)mù
moreover(adv - mɔːrˈəʊvər)hơn thế nữa
delay(n - dɪˈleɪ)chậm trễ
convince(v - kənˈvɪns)thuyết phục
perspective(n - pərˈspektɪv)quan điểm
aim(n - eɪm)mục đích
supplement(v - ˈsʌplɪmənt)bổ sung
bet(v - bet)cược
monk(n - mʌŋk)nhà sư
trust(n - trʌst)lòng tin
brave(adj - breɪv)can đảm
load(v - ləʊd)chất, xếp, dỡ
handle(n - ˈhændl)tay cầm
steady(adj - ˈstedi)vững chắc, ổn định
household(n - ˈhaʊshəʊld)hộ gia đình
disaster(n - dɪˈzæstər)thảm họa
apparent(adj - əˈpærənt)hiện rõ, hiện hữu
devote(v - dɪˈvəʊt)dùng, sử dụng
hike(n - haɪk)đi bộ
compose(v - kəmˈpəʊz)soạn nhạc | music specially composed for the occasion
freeze(v - friːz)làm lạnh, đóng băng
thus(adv - ðʌs)do đó
layer(n - ˈleɪər)lớp
tribe(n - traɪb)bộ lạc
talent(n - ˈtælənt)tài năng
absorb(v - əbˈzɔːrb)hút
honor(v - ˈɑːnər)vinh danh, tôn vinh
border(n - ˈbɔːrdər)biên giới
lung(n - lʌŋ)phổi
crew(n - kruː)hội công nhân
gesture(n - ˈdʒestʃər)cử chỉ
exhausted(adj - ɪɡˈzɔːstɪd)kiệt sức
sensitive(adj - ˈsensətɪv)nhạy cảm
carriage(n - ˈkærɪdʒ)xe ngựa
greenhouse(n - ˈɡriːnhaʊs)nhà kính
end(file)
