01
00
collateral(n - kəˈlætərəl)tài sản thế chấp
autonomous(adj - ɔːˈtɑːnəməs)tự trị | autonomous groups
transparent(adj - trænsˈpærənt)tính minh bạch | a transparent attempt to buy votes (cổ phiếu)
derivative(n - dɪˈrɪvətɪv)công cụ tài chính phái sinh | derivatives are financial instruments whose value is derived from the value of an underlying asset / ... là các công cụ tài chính có giá trị bắt nguồn từ giá trị của tài sản cơ bản
derived(v - dɪˈraɪv)bắt nguồn
precedence(n - ˈpresɪdəns)quyển ưu tiên
exotic(adj - ɪɡˈzɑːtɪk)lạ | she travels to all kinds of exotic locations
toggle(n - ˈtɑːɡl)chuyển đổi | key on a computer that you press to change from one style or operation to another, and back again
credit(n - ˈkredɪt)tín dụng
rating(n - ˈreɪtɪŋ)xếp hạng | The movie carries an R rating (được xếp hàng R)
proposal(n - prəˈpəʊzl)đề xuất | the team is currently reviewing a proposal
obesity(n - əʊˈbiːsəti)béo phì | obesity can increase the risk of heart disease
numerically(adv - nuːˈmerɪkli)về số lượng
ordinarily(adv - ˌɔːrdnˈerəli)thông thường | ordinarily, I prefer to start my day with a cup of coffee
surplus(n - ˈsɜːrplʌs)dư thừa | food surpluses
lengthy(adj - ˈleŋkθi)dài dòng | the meeting turned out to much lengthier than anticipated
opportune(adj - ˌɑːpərˈtuːn)thích hợp, đúng lúc | opptortune for the expansion plans
negotiable(adj - nɪˈɡəʊʃiəbl)thương lượng | the terms of the contract are negotiable
reserved(adj - rɪˈzɜːrvd)kín đáo | she seems quite reserved
rigid(adj - ˈrɪdʒɪd)cứng nhắc | the curriculum was too rigid
criteria(n - kraɪˈtɪriən)tiêu chí | the main criterion is value for money
discretion(n - dɪˈskreʃn)thận trọng | rely on your discretion
laughter(n - ˈlæftər)nụ cười/tiếng cười| 
immune(adj - ɪˈmjuːn)miễn dịch | vaccination helps strengthen the immune system (tiêm chugnr giúp tăng hệ thống miễn dịch)
suburb(n - ˈsʌbɜːrb)ngoại ô | move to a peaceful suburb
discard(v - dɪˈskɑːrd)bỏ đi, bỏ qua | discard any expired items
impose(v - ɪmˈpəʊz)áp đạt | impose a penalty
sanction(n - ˈsæŋkʃn)trừng phạt | sanctions were impose on the country
amend(v - əˈmend)sửa đổi | The committee decided to amend the bylaws (nội quy)
comply(v - kəmˈplaɪ)tuân thủ | it is important to comply with workspace safety regulations
endure(v - ɪnˈdʊr)chịu đựng | He had to endure the racist
prolong(v - prəˈlɔːŋ)gia hạng, kéo dài | the marathon runner tried to prolong his enery
aquarium(n - əˈkweriəm)hải dương | the new aquarium in town
disturbance(n - dɪˈstɜːrbəns)xáo trộn | a significant disturbance in our peaceful evening
fatigue(n- fətiːɡ)mệt mỏi | after a long day of work, she felt a deep sense of fatigue (cực kỳ mệt mỏi)
outlet(n - ˈaʊtlet)ổ cắm | power outlet adaptors (bộ chuyển đổi ổ cắm điện)
rehabilitation(n - ˌriːəˌbɪlɪˈteɪʃn)sự phục hồi | the injured athlete underwent months ò rehabilitation (vận động viên bị thương đã trải qua nhiều tháng phục hồi chức năng)
sanitation(n - ˌsænɪˈteɪʃn)vệ sinh môi trường | new sanitation measures (biện pháp vệ sinh mới)
landmine(n - ˈlændmaɪn)mìn | areas of landmines
remnant(n - ˈremnənt)tàn dư | the woods are remnants of a huge forest
allege(v - əˈledʒ)cáo buộc | alleges that she was driving carelessly
commemorate(v - kəˈmeməreɪt)kỷ niệm | commemorate a historic event
scorer(n - ˈskɔːrər)người ghi bàn | a prolific scorer (người ghi bàn xuất sắc)
associate(n - əˈsəʊsieɪt)đối tác | an associate of the research institude
prestigious(adj - preˈstiːdʒəs)uy tín | a prestigious landmark in the city (một địa danh uy tín)
demolish(v - dɪˈmɑːlɪʃ)phá bỏ | demolish the old factory
obscure(adj - əbˈskjʊr)mờ mịt | obscure the view of the mountains in the distance
eminent(adj - ˈemɪnənt)lỗi lạc | an eminent architect
fundraiser(n - ˈfʌndreɪzər)buổi gây quỹ | a successful fundraiser
predecessor(n - ˈpredəsesər)người tiền nhiệm | the policies of his predecessor
prominent(adj - ˈprɑːmɪnənt)nổi bật | he played a prominent part in the campaign
franchise(n - ˈfræntʃaɪz)thương mại | a franchise agreement (thỏa thuận nhượng quyền thương mại)
domestic(n - dəˈmestɪk)trong nước/nội địa
drastic(adj - ˈdræstɪk)quyết liệt, đột ngột | a drastic reduction
distress(n - dɪˈstres)đau khổ | she was clearly in distress
ascend(v - əˈsend)đi lên | the path started to ascend more steeply
mutate(v - ˈmjuːteɪt)biến đổi | mutated genes
dissect(v - dɪˈsekt)mổ xẻ | dissect a rat
parse(v - pɑːrs)phân tích cú pháp
precision(n - prɪˈsɪʒn)độ chính xác | lacks precision
dangle(v - ˈdæŋɡl)đung đưa/lơ lửng | he dangled his legs
parentheses(n - pəˈrenθəsiːz)dấu ngoặc đơn
comma(n - ˈkɑːmə)dấu phẩy
square bracket(n - ˈskwer brækɪt)dấu ngoặc vuông
semi-colon(n - ˈsemikəʊlən)dấu chấm phẩy
enforce(v - ɪnˈfɔːrs)thực thi | enforce the law
idiomatic(adj - ˌɪdiəˈmætɪk)thành ngữ
ampersand(n - ˈæmpərsænd)dấu và
outlive(v - ˌaʊtˈlɪv)sống lâu hơn | outlive many others in the region (sống lâu hơn nhiều người khác trong khu vực)
sidestep(v - ˈsaɪdstep)tránh né | sidestep the issue
manipulate(v - məˈnɪpjuleɪt)vận dụng | manipulate the situation to his advantage
culmination(n - ˌkʌlmɪˈneɪʃn)đỉnh cao | the culmination of months of hard work
intuitive(adj - ɪnˈtuːɪtɪv)trực quan | Her intuitive understanding of customer needs  (sự hiểu biết trực quan về nhu cầu của khách hàng)
reworking(n - ˌriːˈwɜːrkɪŋ)làm lại, thực hiện lại | the project required extensive reworking
regardless of(prep - rɪˈɡɑːrdləs əv)mặc dù/bất kể | regardless of the obstacles they faced along the way.
incentivize(v - ɪnˈsentɪvaɪz)khuyến khích | ways to incentivize innovation
governance(n - ˈɡʌvərnəns)khả năng quản trị | Effective governance is crucial for maintaining stability in any organization
overtake(v - ˌəʊvərˈteɪk)vượt qua | overtake traditional method
mechanical(adj - məˈkænɪkl)cơ khí | a mechanical device
bidder(n - ˈbɪdər)người đặt giá thầu | the highest bidder (người đặt giá thầu cao nhất)
counterparty(n - ˈkaʊntərpɑːrt)đối tác | with his chinese counterpart
illiquid(adj - ˌilˈlikwəd)kém thanh khoản
viable(adj - ˈvaɪəbl)khả thi | a viable option
bankrupt(adj - ˈbæŋkrʌpt)phá sản | they went backrupt in 2009
accrue(v - əˈkruː)tích lũy | the firm had accrued debts of over $6m (công ty đã tích lũy khoản nợ hơn 6m đô)
arbitrage(n - ˈɑːrbɪtrɑːʒ)chênh lệch
slippage(n - ˈslɪpɪdʒ)sự trượt dốc | the smallest slippage
constantly(adv - ˈkɑːnstəntli)liên tục
engagement(n - ɪnˈɡeɪdʒmənt)mức độ tương tác/ sự gắn kết | the lack of engagement in politics
accomplishment(n - əˈkɑːmplɪʃmənt)thành tựu | greatest accomplishment
preference(n - ˈprefrəns)sự ưu tiên/sở thích | personal preference
badge(n - bædʒ)huy hiệu |  a badge of power
release(v - rɪˈliːs)ra mắt/phát hành/công bố/thả ra | Onirus Software will not be releasing any new software in the foreseealbe future
inclement(adj - ɪnˈklemənt)khắc nghiệt | inclement weather
bakery(n - ˈbeɪkəri)cửa hàng bánh mì
devise(v - dɪˈvaɪz)nghĩ ra | he devised a successful traning workshop
cross-country(n - ˌkrɔːs ˈkʌntri)xuyên quốc gia
across the country(t - t)trên toàn quốc | moving to next town or across the country
incredible(adj - ɪnˈkredəbl)đáng kinh ngạc | an incredible story
perpetual(adj - pərˈpetʃuəl)liên tục | perpetual interruption
inflation(n - ɪnˈfleɪʃn)lạm phát | to reduce inflation
ratio(n - ˈreɪʃiəʊ)tỷ lệ | ratio men to women
dictate(v - ˈdɪkteɪt)quyết định | ratio of the token dicates price
proportion(n - prəˈpɔːrʃn)tỷ lệ | water covers a large proportion of the earth's surface
end(file)
