18
10
floor plan(n - ˈflɔːr plæn)sơ đồ mặt bằng
manual(n - ˈmænjuəl)hướng dẫn sử dụng|Why don’t you read the manual?
receipt(n - rɪˈsiːt)biên nhận, biên lai|Can I have a receipt, please?
item(n - ˈaɪtəm)món đồ|Can I pay for each item separately?
loyalty card(n - lɔɪəlti kɑːrd)thẻ khách hàng thân thiết
producer(n - prəˈduːsər)nhà sx truyền hình|French wine producers
initiative(n - ɪˈnɪʃətɪv)sáng kiến|a United Nations peace initiative 'liên hợp quốc'
machinery(n - məˈʃiːnəri)máy móc|a piece of machinery
negotiate(v - nɪˈɡəʊʃieɪt)thương lượng| They have refused to negotiate on this issue.
board(n - bɔːrd)hội đồng quản trị, hội đồng, ban, cục | Gas Safety Board()ban/cục an toàn ga
luncheon(n - ˈlʌntʃən)tiệc trưa|Luncheon will be served, Madam.
inventory(n - ˈɪnvəntɔːri)hàng tồn kho|The inventory will be disposed of over the next twelve weeks.
rebate(n - ˈriːbeɪt)giám giá|Buyers are offered a cash rebate.
retreat(n - rɪˈtriːt)rút lui|Napoleon’s retreat from Moscow
industry(n - ˈɪndəstri)ngành, ngành công nghiệp|She got a job in industry.
soy sauce(n - ˌsɔɪ ˈsɔːs)xì dầu
partner(v - ˈpɑːrtnər)hợp tác|We are very excited to be partnering with
publicity(n - pʌbˈlɪsəti)công chúng, dư luận|publicity surrounding his disappearance
booth(n - buːθ)gian hàng|The stalls and booths were doing well
aspiring(adj - əˈspaɪərɪŋ)tham vọng|Aspiring musicians need hours of practice every day.
revolutionary(adj - ˌrevəˈluːʃəneri)cách mạng|a revolutionary leader
glassware(n - ˈɡlæswer)thủy tinh
cutting edge(n - ˌkʌtɪŋ ˈedʒ)tiên tiến|working at the cutting edge of computer technology
screening(n - ˈskriːnɪŋ)buổi chiếu phim|This will be the movie's first screening in this country.
cuisine(n - kwɪˈziːn)ẩm thực|Italian cuisine
excerpt(v - ekˈsɜːrpt)trích đoạn|The document was excerpted from an unidentified FBI file.
counter(n - ˈkaʊntər)quầy| I asked the woman behind the counter if they had any postcards.
programmable(adj - ˈprəʊɡræməbl)có thể lập trình
complication(n - ˌkɑːmplɪˈkeɪʃn)biến chứng|She developed complications after the surgery. 'bị biến chứng'
unload(v - ˌʌnˈləʊd)dỡ hàng|The truck driver was waiting to unload.
tray(n - treɪ)khay
stove(n - stəʊv)bếp
stir(n - ˈstɜːr)khuấy|She stirred her tea.
nursing(n - ˈnɜːrsɪŋ)ngành điều dưỡng, điều dưỡng
facility(n - fəˈsɪləti)cơ sở|medical/educational facilities
press release(n - pres)thông cáo báo chí|the foreign press
manual(adj - ˈmænjuəl)làm bằng tay, thủ công|manual skills
screenplay(n - ˈskriːnpleɪ)kịch bản phim|She won an Oscar for the movie’s screenplay.
prospective(adj - prəˈspektɪv)tiềm năng, triển vọng|I had a phone call from a prospective client today.
complex(n - ˈkɑːmpleks)khu phức hợp|a sports/leisure/shopping complex
chief(n - tʃiːf)trưởng phòng, giám đốc|Chief of Surgery 'trưởng phòng phẫu thuật
rehearsal(n - rɪˈhɜːrsl)diễn tập
accommodate(v - əˈkɑːmədeɪt)thích ứng|I needed to accommodate to the new schedule.
venue(n - ˈvenjuː)địa điểm|entertainment venues
competence(n - ˈkɑːmpɪtəns)năng lực|to gain a high level of competence in English 'trình độ cao về năng lực tiếng anh'
proximity(n - prɑːkˈsɪməti)gần|a house in the proximity of the motorway 'gần đường cao tốc'
poorly(adv - ˈpʊrli)kém|poorly designed
unveil(v - ˌʌnˈveɪl)tiết lộ, ra mắt
hedge(n - hedʒ)hàng rào
commissione(v - kəˈmɪʃn)ủy quyền|she has been commissioned to write a new national anthem 'quốc ca'
nursery(n - ˈnɜːrsəri)vườn ươm
spokesperson(n - ˈspəʊkspɜːrsn)ngưới phát ngôn|a council spokesperson
conservatory(n - kənˈsɜːrvətɔːri)nhạc viện
state of the art(adj - ˌsteɪt əv ði ˈɑːrt)hiện đại nhất|The system was state of the art.
faculty(n - ˈfæklti)khoa|the Faculty of Law
adjacent(adj - əˈdʒeɪsnt)liền kề|numbers that are adjacent in the sequence 'số liền kề trong dãy'
recall(v - rɪˈkɔːl)thu hồi|The company has recalled all the faulty hairdryers. 'máy cắt tóc  bị lỗi'
conversion(n - kənˈvɜːrʒn)chuyển đổi|Their main business is the conversion of farm buildings into family homes.
troubleshooting(n - ˈtrʌblʃuːtɪŋ)khắc phục sự cố
defect(n - ˈdiːfekt)khiếm khuyết|a speech defect 'khiếm khuyết về giọng nói'
clarity(n - ˈklærəti)sự rõ ràng|a lack of clarity in the law
questionnaire(n - ˌkwestʃəˈner)bảng câu hỏi|to fill in a questionnaire
terminal - ˈtɜːrmɪnl/(n)bến (bến phà, trạm cuối)|Your flight leaves from Terminal 3.
round-trip(adj - ˌraʊnd ˈtrɪp)khứ hồi|a round-trip flight
holder(n - ˈhəʊldər)ngăn đựng, hộp đựng|a pen holder
restock(v - ˌriːˈstɑːk)bổ sung|Environmentalists are planning to restock the river with fish.
understanding(n - ˌʌndərˈstændɪŋ)sự thấu hiểu|a clear understanding of something
break-time(n - ˈbreɪk taɪm)giải lao
feature(n - ˈfiːtʃər):đặc điểm
feature(v - ˈfiːtʃər)có, nổi tiếng, nổi bật|a new Star Wars movie featuring the original actors
acclaim(v - əˈkleɪm)được hoan nghênh|a widely acclaimed performance
dub(v - dʌb)mệnh danh|Genetically modified products have been dubbed ‘Frankenfoods’ 'sản phẩm biến đổi gen'
debut(n - deɪˈbjuː)buổi ra mắt
praise(n - preɪz)khen|for special praise.
curator(n - ˈkjʊreɪtər)người phụ trách
contractor(n - ˈkɑːntræktər)nhà thầu|a building/electrical contractor
countertop(n - ˈkaʊntərtɑːp)mặt bàn
faucet(n - ˈfɔːsɪt)vòi nước
reduction(n - rɪˈdʌkʃn)giảm|a drastic reduction in costs
upfront(adj - ˌʌpˈfrʌnt)trả trước|There will be an upfront fee of 4%.
remainder(n - rɪˈmeɪndər)phần còn lại|I kept some of his books and gave away the remainder.
overestimate(v - ˌəʊvərˈestɪmeɪt)đánh giá quá cao|They overestimated his ability when they promoted him.
preregistration(n - ˌpriːredʒɪˈstreɪʃn)việc chuẩn bị, đăng ký trước
workshop(n - ˈwɜːrkʃɑːp)hội thảo|She was invited to participate in a workshop
association(n - əˌsəʊʃiˈeɪʃn)hiệp hội|a residents’ association
coordinator(n - kəʊˈɔːrdɪneɪtər)điều phối viên|The campaign needs an effective coordinator.
postage(n - ˈpəʊstɪdʒ)bưu phí| All prices include postage and packing.
commentary(n - ˈkɑːmənteri)bài viết|a sports commentary
affair(n - əˈfer)vấn đề|international affairs
storeroom(n - ˈstɔːrʊm)nhà kho|Where’s the key to the storeroom?
shuttle(n - ˈʃʌtl)xe đưa đón|a shuttle service between London and Edinburgh
barge(n - bɑːrdʒ)xà lan|They travel by barge.
anchor(n - ˈæŋkər)neo
postcard-worthy(n - ˈpəʊstkɑːrd)bưu thiếp|colourful postcards of California
end(file)
