10
10
hub(n - hʌb)trung tâm | The airport has become an international hub.
partnership(n - ˈpɑːrtnərʃɪp)quan hệ đối tác | partnership with an American expert
refine(v - rɪˈfaɪn)tinh chỉnh | This theory still needs a little refining.
rectify(v - ˈrektɪfaɪ)khắc phục | to rectify a fault
liaise(v - liˈeɪz)liên lạc | I will liaise with the marketing team
desirable(adj - dɪˈzaɪərəbl)mong muốn | desiable feature
demeanor(n - dɪˈmiːnər)phong thái | a professional demeanour
robust(adj - rəʊˈbʌst)mạnh mẽ | but still very robust
quotation(n - kwəʊˈteɪʃn)bảng báo giá | need to get a written quotation/ cần lấy bảng báo giá bằng văn bản
literary(adj - ˈlɪtəreri)văn học | literary riticism/ phê bình văn học
adhere(v - ədˈhɪr)tuân thủ | all members must adhere to the rules
work(n - wɜːrk)tác phẩm | works of fiction/literature/ tác phẩm hư cấu/văn học
shortening(n - ˈʃɔːrtnɪŋ)rút ngắn | The shortening of the workweek
water lily(n - ˈwɔːtər lɪli)hoa súng 
trek(n - trek)đi bộ | an two-day trek across the mountains/chuyến đi bộ 2 ngày xuyên núi
restoration(n - restəˈreɪʃn)phục hồi | the building is under restoration
tripod(n - ˈtraɪpɑːd)giá 3 chân | the camera was mounted on a tripod
sidewalk(n - ˈsaɪdwɔːk)vỉa hè | people were walking along the sidewalk
skyscraper(n - ˈskaɪskreɪpər)tòa nhà chọc trời | the city's skyline is filled with skyscraper
tow(v - təʊ)kéo | Our car was towed away by the police. | 
pile up(t - t)chất đống | Problems were beginning to pile up
lined up(t - t)xếp hàng | lined up along a walkway
crate(n - kreɪt)cái thùng | a crate of apples
cabinets(n - ˈkæbɪnət)tủ | kitchen cabinets
thermostat(n - ˈθɜːrməstæt)máy điều nhiệt | the thermostat controles the temperature
invoice(n - ˈɪnvɔɪs)hóa đơn | invoice for the goods/hóa đơn cho hàng hóa
cover(n - n)bìa /bìa báo, sách, .. | the cover of the book
chop(v - tʃɑːp)chặt, cắt| chopping logs 
blend(v - blend)trộn | blend the ingredients together
blender(n - ˈblendər)máy xay | use a blender to make smoothies 'sinh tố'
knock off(t - t)giảm giá | knocked off $60
waive(v -weɪv)được miễn | waive the tuition fee/miễn học phí
veterinarian(n - ˌvetərɪˈneriən)bác sỹ thú y | the veterinarian treated 'chữa trị' the sick dog
the lease(n - n) hợp đồng thuê | under the terms of the lease/theo điều khoản của hợp đồng thuê
spare parts(n - ˌsper ˈpɑːrt)phụ tùng | We have to get our spare parts from abroad
e-reader(n - ˈiː riːdər)máy đọc sách điện tử | she prefer reading on her e-reader
opening(t - t)công việc có sẵn | There are several openings in the sales department
narrow down(phrasal verb)thu hẹp | We narrowed the choices 
bouquet(n - buˈkeɪ)bó hoa | a wedding bouquet
mouth-watering(adj - ˈmaʊθ wɔːtərɪŋ)ngon miệng | the food look mouth-watering
signature(n - ˈsɪɡnətʃər)đặc trưng | Bright colours are his signature. | bright colers are his signature
spice(n - spaɪs)gia vị | various spice
insight(n - ˈɪnsaɪt)hiểu biết | several useful insights
vacant(adj - ˈveɪkənt)chỗ trống | the seat next to him was vacant
rise(n - raɪz)sự thăng tiến, sự trỗi dậy | the rise of digital media 'truyền thông kts'
focus(v - ˈfəʊkəs)tiêu điểm (Business Focus) 
elaborate(adj - ɪˈlæbərət)phức tạp | elaborate designs
top-notch(adj -ˌtɑːp ˈnɑːtʃ)hàng đầu | top-notch service
pastry(n - ˈpeɪstri)bánh ngọt | she bought some pastries
transitional(adj - trænˈzɪʃənl)chuyển tiếp | a transitional period/một giai đoạn chuyển tiếp
pier(n - pɪr)bến tàu | walk along the pier
overlook(t - t)nhìn ra | a restaurant overlooking the lake
complement(v - ˈkɑːmplɪment)bổ sung | The excellent menu is complemented by a good wine list.
modest(adj - ˈmɑːdɪst)khiêm tốn | She's very modest about her success
prudent(adj - ˈpruːdnt)khôn ngoan | a prudent businessman
underestimated(v - ˌʌndərˈestɪmeɪt)đánh giá quá thấp | underestimate the cost of the project
auditor(n - ˈɔːdɪtər)kiểm toán viên | The auditors’ report
mutually(adv - ˈmjuːtʃuəli)hỗ trợ | they mutually agreed the terms
lean(v - liːn)dựa vào | She leaned her head against his shoulder
shipment(n - ˈʃɪpmənt)việc giao hàng, lô hàng | the shipment arrived on time
port(n - pɔːrt)cảng | a container port
stuffing(n - stʌfɪŋ)nhét | stuffing some clothes into a bag
shore(n - ʃɔːr)bờ biển | swim from boat to the shore
brunch(n - brʌntʃ)bữa sáng muộn | go out for brunch (ý là thời gian an sáng)
bid(n - bɪd)giá thầu | takeover bid for the company/ đấu thầu mua lại cty
roasted(v - rəʊst)rang | roasted coffee beans/peanuts
kebabs(n - kɪˈbɑːb)thịt nướng 
township(n - ˈtaʊnʃɪp)thị trấn | a town or part of a town that black people had to live in, and where only black people lived
parade(n - pəˈreɪd)diễu hành | a parade on the main street 
St.(t - t)viết tắt của saint, ý chỉ một người tốt bụng, nhận được vinh dự lớn từ mọi người.
tourism(n - ˈtʊrɪzəm)du lịch | the tourism industry/ngành du lịch
ballroom(n - ˈbɔːlruːm)phòng khiêu vũ | the hotel há a grand ballroom 'phòng khiêu vũ lớn'
wristwatch(n - ˈrɪstwɑːtʃ)đồng hồ đeo tay 
thrilled(adj - θrɪld)vui mừng | I was thrilled to be invited.
governor(n - ˈɡʌvərnər)thống đốc | the governor of Arizona
go beyond(n - ˈstɑːpəʊvər)vượt xa | this year's sales figures go beyond all our expectations
stopover(n - ˈstɑːpəʊvər)điểm dừng chân | at each stopover
fellowship(n - ˈfeləʊʃɪp)học bổng | he received a research fellowship
payroll(n - ˈpeɪrəʊl)bảng lương | a monthly payroll of $1 million.
composition(n - ˌkɑːmpəˈzɪʃn)thành phần | a software composition analysis tools
remediation(n - rɪˌmiːdiˈeɪʃn)khắc phục | vulnerability remediation
atomicity(n - ˌætəˈmɪsəti)nguyên tử |  
invariants(adj - ɪnˈveriənt)bất biến | invariant properties
coordinator(n - kəʊˈɔːrdɪneɪtər)điều phối viên | the campaign needs an effective coordinator
abdicate(v - ˈæbdɪkeɪt)thoái vị | he abdicated in favour of his son/ông thoái vị để ủng hộ con trai mình
general(n - ˈdʒenrəl)tướng | a four-star general
end(file)
