15
20
dispersion(n - dɪˈspɜːrʒn)sự phân tán
distribute(v - dɪˈstrɪbjuːt)phân phối, phân phát, phân tán
shelter(n - ˈʃeltər)nơi ở
predator(n - ˈpredətər)kẻ săn mồi
prey(n - preɪ)con mồi
space(v - speɪs)tạo khoảng cách
clump(n - klʌmp)cụm
uniform(adj - ˈjuːnɪfɔːrm)đồng nhất
gather(v - ˈɡæðər)tập trung
patch(n - pætʃ)mảng
reproduction(n - ˌriːprəˈdʌkʃn)sinh sản
humidity(n - hjuːˈmɪdəti)độ ẩm
evenly(adv - ˈiːvnli)như nhau
regular(adj - ˈreɡjələr)đều đặn
repulsion(n - rɪˈpʌlʃn)lực đẩy
absence(n - ˈæbsəns)vắng mặt
rate(n - reɪt)tốc độ
precisely(adv - prɪˈsaɪsli)chính xác
chiropractor(n - ˈkaɪərəʊpræktər)bác sỹ chỉnh hình
appeal(v - əˈpiːl)hấp dẫn, kêu gọi
megabucks(n - ˈmeɡəbʌks)số tiền lớn
pharmaceutical(adj - ˌfɑːrməˈsuːtɪkl)dược phẩm
settle down(phra - empty)ổn định
move on(phra - empty)tiếp tục
journalism(n - ˈdʒɜːrnəlɪzəm)nghề báo
chronic(adj - ˈkrɑːnɪk)mãn tính
common(adj - ˈkɑːmən)phổ biến, chung
sufferer(n - ˈsʌfərər)người mắc bệnh
majority(n - məˈdʒɔːrəti)đa số
miserable(adj - ˈmɪzrəbl)khổ sở
vicious circle(n - ˈvɪʃəs)vòng luẩn quẩn
therapy(n - ˈθerəpi)liệu pháp
mishandle(v - ˌmɪsˈhændl)xử lý sai
menace(n - ˈmenəs)mối đe dọa
counterproductive(adj - ˌkaʊntərprəˈdʌktɪv)phản tác dụng
strain(n - streɪn)căng thẳng
blow(n - bləʊ)cú đánh
widespread(adj - ˈwaɪdspred)diện rộng
argument(n - ˈɑːrɡjumənt)tranh luận
public(n - ˈpʌblɪk)công chúng
recede(v - rɪˈsiːd)rút (nước rút)
glacier(n - ˈɡleɪʃər)sông băng
limb(n - lɪm)chi
immobile(adj - ɪˈməʊbl)bất động
tense(v - tens)căng lên
underway(adj - ˌʌndərˈweɪ)đang diễn ra
stricken(adj - ˈstirɪkən)cực độ
overweight(adj - ˌəʊvərˈweɪt)thừa cân
aggravation(n - ˌæɡrəˈveɪʃn)trầm trọng
slouch(v - slaʊtʃ)chùng xuống
strain(v - streɪn)làm căng
ligament(n - ˈlɪɡəmənt)dây chằng
suggest(v - səɡˈdʒest)đề xuất
posture(n - ˈpɑːstʃər)tư thế
alignment(n - əˈlaɪnmənt)sự liên kết, căn chỉnh
hazard(n - ˈhæzərd)nguy cơ, nguy hiể
remedy(n - ˈremədi)biện pháp
relief(n - rɪˈliːf)sự cứu trợ, sự nhẹ nhõm
distant(adj - ˈdɪstənt)xa xôi
wonder(n - ˈwʌndər)kỳ quan
similar(adj - ˈsɪmələr)tương tự
keystroke(n - ˈkiːstrəʊk)lần nhấn phím
interest(n - ˈɪntrest)sở thích, lợi ích, lãi
obtain(v - əbˈteɪn)lấy
recipient(n - rɪˈsɪpiənt)người nhận
feeling(n - ˈfiːlɪŋ)cảm xúc
mankind(n - mænˈkaɪnd)nhân loại
Confucius(n - empty)khổng tử
rewarding(adj - rɪˈwɔːrdɪŋ)ý nghĩa, bổ ích
hopelessly(adv - ˈhəʊpləsli)vô vọng
voluntarily(adv - ˌvɑːlənˈterəli)tự nguyện
hardship(n - ˈhɑːrdʃɪp)khó khăn
thorny labor(adj - ˈθɔːrni)chông gai
rejoice(v - rɪˈdʒɔɪs)vui mừng
socialize(v - ˈsəʊʃəlaɪz)giao lưu
decent(adj - ˈdiːsnt)khá tốt, tử tế
abundant(adj - əˈbʌndənt)nhiều, đa dạng
well-being(n - ˈwel biːɪŋ)hạnh phúc
civilized( - ˈsɪvəlaɪzd)văn minh
humane(adj - hjuːˈmeɪn)nhân văn
tropical(adj - ˈtrɑːpɪkl)nhiệt đới
vacation(n - vəˈkeɪʃn)kỳ nghỉ
survive(v - sərˈvaɪv)tồn tại
financially(adv - faɪˈnænʃəli)về mặt tài chính
business(n - ˈbɪznəs)kinh doanh, doanh nghiệp
wholeheartedly(adv - ˌhəʊlˈhɑːrtɪdli)hết mình
publishing(n - ˈpʌblɪʃɪŋ)xuất bản
firm(n - fɜːrm)hãng
focused(adj - ˈfəʊkəst)tập trung
stick to(phra - empty)tuân thủ
deadline(n - ˈdedlaɪn)thời hạn, hạn chót
unlikely(adj - ʌnˈlaɪkli)khó có thể
end(file)
