18
22
sunbathe(v - ˈsʌnbeɪð)tắm nắng
figure(n - ˈfɪɡjər)số liệu
vulnerable(adj - ˈvʌlnərəbl)dễ bị
osteoporosis(n - ˌɑːstiəʊpəˈrəʊsɪs)loãng xương
painkiller(n - ˈpeɪnkɪlər)thuốc giảm đau
muscle tension(n - ˈtenʃn)căng cơ
spasm(n - ˈspæzəm)co thắt
gap(n - ɡæp)khoảng trắng
spine(n - spaɪn)cột sống
diet(n - ˈdaɪət)chế độ ăn uống
mattress(n - ˈmætrəs)nệm
heel(n - hiːl)giày cao gót
diverse(adj - daɪˈvɜːrs)đa dạng
norm(n - nɔːrm)nguyên tắc
reliance(n - rɪˈlaɪəns)dựa vào
destiny(n - ˈdestəni)số phận
perceive(v - pərˈsiːv)nhận thức
oneself(pro - wʌnˈself)bản thân
closely(adv - ˈkləʊsli)chặt chẽ, mật thiết
payment(n - ˈpeɪmənt)việc thanh toán
seek(v - siːk)tìm, tìm kiếm
honor(n - ˈɑːnər)vinh danh
precious(adj - ˈpreʃəs)quý báu
utmost(adj - ˈʌtməʊst)cực
nearly(adv - ˈnɪrli)hầu hết
minimize(v - ˈmɪnɪmaɪz)làm giảm
likelihood(n - ˈlaɪklihʊd)khả năng
insult(n - ˈɪnsʌlt)sự xúc phạm
intrude(v - ɪnˈtruːd)sự xâm phạm
scale(n - skeɪl)quy mô
determined(adj - dɪˈtɜːrmɪnd)quyết tâm
suspicion(n - səˈspɪʃn)sự ngờ vực
demand(v - dɪˈmænd)yêu cầu
warrant(n - ˈwɔːrənt)lệnh
willingness(n - ˈwɪlɪŋnəs)sự sẵn lòng, sẵn lòng
carefulness(n - ˈkerflnəs)sự cẩn thận
readiness(n - ˈredinəs)sự sẵn sàng
withdraw(v - wɪθˈdrɔː)rút lui, rút tiền
alternatively(adv - ɔːlˈtɜːrnətɪvli)cách khác, nếu không thỳ
typical(adj - ˈtɪpɪkl)điển hình
craft(n - kræft)thủ công
rubber(n - ˈrʌbər)cao su
decorate(v - ˈdekəreɪt)trang trí
finance(n - ˈfaɪnæns)tài chính
budget(n - ˈbʌdʒɪt)ngân sách
keep up(phra - empty)theo kịp
come up with(phra - empty)nghĩ ra
innovative(adj - ˈɪnəveɪtɪv)sáng tạo
housewife(n - ˈhaʊswaɪf)nội trợ
investment(n - ɪnˈvestmənt)khoản đầu tư
dismiss, sack(v - dɪsˈmɪs sæk)sa thải
misconduct(n - ˌmɪsˈkɑːndʌkt)hành vi sai trái
preliminary(adj - prɪˈlɪmɪneri)sơ bộ
correct, addressed(v - kəˈrekt, əˈdres)giải quyết, khắc phục, sửa, điều chỉnh
dismissal(n - dɪsˈmɪsl)sa thải
charge(v - tʃɑːrdʒ)tính phí, cáo buộc, thu phí
accusation(n - ˌækjuˈzeɪʃn)cáo buộc
appeal(n - əˈpiːl)kháng cáo
hearing(n - ˈhɪrɪŋ)điều trần
disciplinary(adj - ˈdɪsəpləneri)kỷ luật
involve(v - ɪnˈvɑːlv)liên quan đến, liên quan
peculiar(adj - pɪˈkjuːliər)đặc biệt
significant(adj - sɪɡˈnɪfɪkənt)đáng kể
disclaim(v - dɪsˈkleɪm)từ chối
clarify(v - ˈklærəfaɪ)làm rõ
ecology(n - iˈkɑːlədʒi)hệ sinh thái
composition(n - ˌkɑːmpəˈzɪʃn)thành phần
fluctuation(n - ˌflʌktʃuˈeɪʃn)biến động
solely(adv - ˈsəʊlli)chỉ
cause(n - kɔːz)nguyên nhân, mục tiêu
concerned(adj - kənˈsɜːrnd)quan tâm
population(n - ˌpɑːpjuˈleɪʃn)quần thể
consist in(v - kənˈsɪst)bao gồm
species(n - ˈspiːʃiːz)loài
simultaneously(adv - ˌsaɪmlˈteɪniəsli)đồng thời
occupy(v - ˈɑːkjupaɪ)chiếm
interaction(n - ˌɪntərˈækʃn)sự tương tác
shaped(v - ʃeɪpt)hình thành, định hình
favourable(adj - ˈfeɪvərəbl)thuận lợi
adequate(adj - ˈædɪkwət)đủ
habitat(n - ˈhæbɪtæt)môi trường sống
insufficient(adj - ˌɪnsəˈfɪʃnt)thiếu
excessive(adj - ɪkˈsesɪv)quá nhiều
density(n - ˈdensəti)mật độ
maple(n - ˈmeɪpl)cây phong
boundary(n - ˈbaʊndri)ranh giới
geographical(adj - ˌdʒiːəˈɡræfɪkl)địa lý
indirect(adj - ˌɪndəˈrekt)gián tiếp
sampling(n - ˈsæmplɪŋ)lấy mẫu
indicator(n - ˈɪndɪkeɪtər)chỉ số
burrow(n - ˈbɜːrəʊ)hang
track(n - træk)dấu vết
droppings(n - ˈdrɑːpɪŋz)phân
end(file)