10
10
utilization(n - ˌjuːtələˈzeɪʃn)việc sử dụng|the utilization of renewable energy
asymmetric(adj - ˌeɪsɪˈmetrɪk)bất đối xứng|the architect designed an asymmetric building 
homemaker(n - ˈhəʊmmeɪkər)nội trợ|being a homemaker is full-time job
commitment(n - kəˈmɪtmənt)cam kết|his commitment to the project
broom(n - bruːm)chổi|she used a broom to sweep the fallen leaves
mower(n - ˈməʊər)máy cắt cỏ|I need to buy a new mower
spottter(n - ˈspɑːtər)người giám sát|the lifeguard (người giám hộ) acted as a spotter
oversee(v - ˌəʊvərˈsiː)giám sát|the manager will oversee the implementation of the new policy.
cover letter(n - ˈkʌvər letər)thư xin việc|he included a cover letter with his job application
debit(n - ˈdebɪt)ghi nợ|the debit for the purchase
thermostat(n - ˈθɜːrməstæt)máy điều nhiệt|the thermostat helps maintain a comfortable temperature
bulletin(n - ˈbʊlətɪn)bản thông báo|
deposit(n - dɪˈpɑːzɪt)tiền đặt cọc, gửi, gửi tiền|she made a deposit into her savings account every month
versatile(adj - ˈvɜːrsətl) linh hoạt|incredibly 'cực kỳ' versatile
starve(v - stɑːrv)chết đói|starve in the ưilderness
termination(n - ˌtɜːrmɪˈneɪʃn)chấm dứt|the termination of the contract
fair(adj - fer)hội chợ|the local fair
pool(n - puːl)bida|a game of pool
tie(v - taɪ)hòa|the match ended in a tie
obstruct(v - əbˈstrʌkt)cản trở|the fallen tree obstructed the road
spoil(v - spɔɪl)làm hỏng|leaving the milk out of the fridge too long can spoil it
foreground(n - ˈfɔːrɡraʊnd)phía trước|
intended(adj - ɪnˈtendɪd)dự định|the intended purpose of the meeting
pharmacy(n - ˈfɑːrməsi)nhà thuốc|I need to stop by the pharmacy
depict(v - dɪˈpɪkt)miêu tả|the painting depicts a landscape
particularly(adv - pərˈtɪkjələrli)đặc biệt|she is particularly interested in learning more about biololy (sinh vật)
publication(n - ˌpʌblɪˈkeɪʃn)ấn phẩm|the new publication
raise(v - reɪz)nâng lên|raise the heavy box
hood(n - hʊd)mui  xe|the car's hood
toaster(n - ˈtəʊstər)lò nướng bánh mỳ|she bought a new toaster 
slash(v - slæʃ)giảm, cắt giảm|the company had to slash prices to attract more customers
restraint(n - rɪˈstreɪnt)kiềm chế, hạn chế|the goverment imposed 'áp đặt' restraints on certain types of financial transactions
fate(n - feɪt)số phận|
reinstate(v - ˌriːɪnˈsteɪt)phục hồi|the employee was reinstated
triggered(v - ˈtrɪɡər)kích hoạt
overlook(v - ˌəʊvərˈlʊk)nhìn ra|the restaurant's patio 'hiên' overlooks the beautiful lake 
hit(n - hɪt)là điểm nhấn|the biggest hit of the park
finance(n - ˈfaɪnæns)tài trợ|the project was financed by a group of private investors
assemble(v - əˈsembl)lắp ráp|the workers assembled the funiture quickly and effective
pylon(n - ˈpaɪlən)cột, trụ|the electricity pylon
concrete(adj - ˈkɑːnkriːt)bê tông|the concrete structure
blend(v - blend)hòa hợp/hòa trộn|blend the flavors perfectly
speciality(n - ˌspeʃiˈæləti)chuyên môn|her speciality is creating custom-made jewelry
vacate(v - ˈveɪkeɪt)bỏ trống, rời đi|vacate the premises
renovation(n - ˌrenəˈveɪʃn)cải tạo
relocate(v - ˌriːˈləʊkeɪt)chuyển vị trí, tái định cư, di dời
herb(n - hɜːrb)thảo mộc|the herb garden
barn(n - bɑːrn)chuồng
pesticide(n - ˈpestɪsaɪd)thuốc trừ sâu
herbicides(n - ˈhɜːrbɪsaɪd)thuốc diệt cỏ
flyer(n - ˈflaɪər)tờ rơi|the company distributed flyers
newsletter(n - ˈnuːzletər)bản tin|I receive a newsletter
host(v - həʊst)tổ chức|they will host the annual conference
rental(n - ˈrentl)cho thuê|arrange the rental
access(v - ˈækses)tiếp cận, truy cập, kết nối|access the databse, lounge access 'việc tiếp cận phòng chờ'
utility(n - juːˈtɪləti)tiện ích|the moderm utilities
potentially(adv - pəˈtenʃəli)có thể|the new technology potentially revolutionizes the industry
inquire(v - ɪnˈkwaɪər)hỏi thăm, hỏi|inquire about
upkeep(n - ˈʌpkiːp)bảo dưỡng|regular upkeep
residential(adj - ˌrezɪˈdenʃl)khu dân cư|the area is a residential
residence(n - ˈrezɪdəns)nơi cư trú|his residence
prefer(v - prɪˈfɜːr)ưu tiên, ưa chuộng|I prefer to take the bus instead the bus
last(v - læst)tồn tại, kéo dài
kitchenware(n - ˈkɪtʃɪnwer)đồ dùng nhà bếp
caterer(n - ˈkeɪtərər)người phục vụ đồ ăn, nhà cung cấp đồ ăn
straightforward(adj - ˌstreɪtˈfɔːrwərd)đơn giản
exceptionally(adv - ɪkˈsepʃənəli)đặc biệt|she performed exceptionally well
portable(adj - ˈpɔːrtəbl)cầm tay|the portable speaker
powerful(adj - ˈpaʊərfl)mạnh mẽ|a powerful motor
motor(n - ˈməʊtər)động cơ|
reassurance(n - ˌriːəˈʃʊrəns)sự đảm bảo, sự an tâm, sự trấn an|sence of reassurance
durable(adj - ˈdʊrəbl)bền
optional(adj - ˈɑːpʃənl)tùy chọn
inaugurate(v - ɪˈnɔːɡjəreɪt)khánh thành|inaugurate the new community center
refurbish(v - ˌriːˈfɜːrbɪʃ)tân trang|refurbish the old building
arena(n - əˈriːnə)đấu trường
incentive(n - ɪnˈsentɪv)sự khích lệ|an incentive program
reserve(v - rɪˈzɜːrv)dành cho|this section is reserved fo VIP guests
look(n - lʊk)ngoại hình|the look of the new model
gotta(v - ˈɡɑːtə)cần phải| I gotta finish this project
youngster(n - ˈjʌŋstər)người trẻ
unfit(adj - ʌnˈfɪt)thừa cân|he was unfit
increasingly(adv - ɪnˈkriːsɪŋli)ngày càng|it is becoming increasingly difficult
lateness(n - ˈleɪtnəs)sự muộn màng, sự chậm trễ
showcase(n - ˈʃəʊkeɪs)buổi giới thiệu
favorable, favorably(adj, adv - ˈfeɪvərəbl)thuận lợi, có lợi|the weather conditions were favorable for the outdoor event
scattered(adj - ˈskætərd)rải rác|the houses in the countryside were scattered across the landscape
planner(n - ˈplænər)người lập kế hoạch
prototype(n - ˈprəʊtətaɪp)mẫu|the prototype of the new device
finalize(v - ˈfaɪnəlaɪz)hoàn thiện|we need to finalize the details of the agreement
own(v - əʊn)sở hữu|she plans to owns her own business someday
adjustable(adj - əˈdʒʌstəbl)có thể điều chỉnh|the office chair is adjustable
orchard(n - ˈɔːrtʃərd)vường cây ăn quả
pear(n - per)lê
nearby(adj - ˌnɪrˈbaɪ)gần đây|there's a great restaurant nearby that we can go to for lunch
end(file)
