1
1
indifferent(adj - ɪnˈdɪfrənt)thờ ơ|bad and indifferent.
loan(n - ləʊn)tiền vay
expenditure(n - ɪkˈspendɪtʃər)chi tiêu|plans to increase expenditure on health
backtrack(v - ˈbæktræk)quay lui|The path suddenly disappeared and we had to backtrack.
freeway(n - ˈfriːweɪ)xa lộ
crunchy(adj - ˈkrʌntʃi)giòn|a crunchy salad
contestant(n - kənˈtestənt)thí sinh
crime(n - kraɪm)tội phạm|This month's figures show an increase in violent crime 'tội phạm bạo lực'
convicted(v - kənˈvɪktɪd)kết tội|He was convicted of fraud 'gian lận'
suppose(v - səˈpəʊz)cho là, giả sử|Prices will go up, I suppose 'tôi cho là giá cả sẽ tăng lên'
symposium(n - sɪmˈpəʊziəm)hội nghị chuyên đề
necklace(n - ˈnekləs)chuỗi hạt|a diamond necklace
respectively(adv - rɪˈspektɪvli)tương ứng|Julie and Mark, aged 17 and 19 respectively
shoplifting(n - ˈʃɑːplɪftɪŋ)trộm cắp|She was convicted of shoplifting 'bị kết tội trộm cắp'
refreshment(n - rɪˈfreʃmənt)giải khát
intermission(n - ˌɪntərˈmɪʃn)tạm nghỉ|Coffee was served during the intermission.
raffle(n - ˈræfl)xổ số|raffle ticket
inhabited(adj - ɪnˈhæbɪtɪd)có người ở|The island is no longer inhabited.
tram(n - træm)xe điện|a tram route
reconsider(v - ˌriːkənˈsɪdər)xem xét lại
petition(n - pəˈtɪʃn)đơn thỉnh cầu|deliver a petition
brochure(n - broʊˈʃʊr)tập tài liệu|a travel brochure
eligible(adj - ˈelɪdʒəbl)đủ điều kiện|The new regulations made a lot of prisoners eligible for early release.
cable(n - ˈkeɪbl)cáp
evacuate(v - ɪˈvækjueɪt)sơ tán
sector(n - ˈsektər)lĩnh vực|We have seen rapid growth in the services sector.
fabric(n - ˈfæbrɪk)vải|furnishing fabrics 'vải trang trí nội thất'
comedian(n - kəˈmiːdiən)diễn viên hài
pile(n - paɪl)đống, chất đống|a pile of clothes
soundtrack(n - ˈsaʊndtræk)bản nhạc phim
dining room(n - ˈdaɪnɪŋ ruːm)phòng ăn
ultimate(adj - ˈʌltɪmət)tối ưu|This race will be the ultimate test of your skill.
patio(n - ˈpæti.oʊ)sân
check(n - tʃek)tấm séc
remodeled(v - ˌriːˈmɑːdld)tư sửa|The interior of the building has been completely remodeled 'nội thất của tòa nhà'
contain(v - kənˈteɪn)ngăn chặn|to contain an epidemic
receptionist(n - rɪˈsepʃənɪst)lễ tân
biologist(n - baɪˈɑːlədʒɪst)nhà sinh vật học
tournament(n - ˈtʊrnəmənt)giải đấu
storey(n - ˈstɔːri)tầng|the upper - lower storey of the house
arrest(v - əˈrest)bắt giữ|Police arrested three suspects 'nghi phạm'
reckless(adj - ˈrekləs)liều lĩnh|she was a good rider, but reckless
magician(n - məˈdʒɪʃn)nhà ảo thuật|They had booked a magician for the children’s party.
microbiology(n - ˌmaɪkroʊbaɪˈɑːlədʒi)vi trùng học
file(v - faɪl)gửi đơn|The forms should be filed alphabetically.
deal(n - diːl)thỏa thuận, giao dịch, ưu đãi|to sign a deal
block(v - blɑːk)gây tắc nghẽn|After today's heavy snow, many roads are still blocked.
unethical(adj - ʌnˈeθɪkl)phi đạo đức|of unethical behaviour.
receiver(n - rɪˈsiːvər)đầu thu|to replace the receiver
insurance life(n - ɪnˈʃʊrəns laɪf)bảo hiểm nhân thọ
traffic(n - ˈtræfɪk)giao thông|a plan to reduce traffic congestion
shaving cream(n - ˈʃeɪvɪŋ kriːm)kem cạo râu
dealer(n - ˈdiːlər)đại lý|antique dealer 'đồ cổ'
locker room(n - ˈlɑːkər ruːm)phòng thay đồ
faithful(adj - ˈfeɪθfl)trung thành|I have been a faithful reader of your newspaper for many years.
redeem(v - rɪˈdiːm)đổi|This voucher can be redeemed at any of our branches.
categorize(v - ˈkætəɡəraɪz)phân loại|Participants were categorized according to age.
gallery(n - ˈɡæləri)phòng trưng bày|picture gallery
water polo(n - ˈwɔːtər poʊloʊ)bóng nước
underneath(prep - ˌʌndərˈniːθ)bên dưới|The coin rolled underneath the piano.
scuba diving(n - ˈskuːbə daɪvɪŋ)môn lặn|scuba equipment
department store(n - dɪˈpɑːrtmənt stɔːr)cửa hàng bách hóa
entitled(adj - ɪnˈtaɪtld)ban được quyền|Everyone's entitled to their own opinion 'được quyền có ý kiến'
observe(v - əbˈzɜːrv)tuân thủ|Will the rebels observe the ceasefire? 'liệu phiến quân có tuân thủ lệnh ngừng bắn'
capability(n - ˌkeɪpəˈbɪləti)khả năng|Age affects the range of a person's capabilities 'phạm vi khả năng của một người'
mostly(adv - ˈmoʊstli)hầu hết|The sauce is mostly cream
hospitality(n - ˌhɑːspɪˈtæləti)tiếp đãi, khách sạn|Thank you for your kind hospitality, hospitality business.
wanted(v - ˈwɑːntɪd)tuyển dụng, truy nã
abstract(adj - ˈæbstrækt)tóm tắt|abstract knowledge
cautious(adj - ˈkɔːʃəs)thận trọng|They've taken a very cautious approach 'thực hiện tiếp cận rất thận trọng'
insurance(n - ɪnˈʃʊrəns)bảo hiểm
coverage(n - ˈkʌvərɪdʒ)việc đưa tin, bao quát|tonight’s live coverage, general coverage of the subject.
risky(adj - ˈrɪski)rủi ro|It's far too risky to generalize from one set of results. 'khái quát một bộ kết quả'
gamble(v - ˈɡæmbl)cá cược|to gamble on the horses
renew(v - rɪˈnuː)gia hạn|to renew a licence
toner(n - ˈtoʊnər)mực
accredited(adj - əˈkredɪtɪd)danh tiếng|an accredited school
overturn(v - ˌoʊvərˈtɜːrn)lật ngược|the car skidded and overturned
cartridge(n - ˈkɑːrtrɪdʒ)hộp mực máy in
interstate(adj - ˌɪntərˈsteɪt)liên bang|interstate commerce
packaging(n - ˈpækɪdʒɪŋ)bao bì|Attractive packaging can help to sell products.
unplug(v - ˌʌnˈplʌɡ)rút phích cắm|If I’m very busy, I unplug the phone.
napkin(n - ˈnæpkɪn)khăn ăn|He tucked his napkin under his chin 'nhét'
subscription(n - səbˈskrɪpʃn)đăng ký
preparatory(adj - prɪˈpærətɔːri)chuẩn bị|After a few preparatory drawings 'bản vẽ'
inventory(n - ˈɪnvəntɔːri)hàng tồn kho
end(file)