28
14
acidity(n - əˈsɪdəti)độ chua
overflow(v - ˌəʊvərˈfləʊ)tràn đầy
beneath(prep - bɪˈniːθ)ở dưới
noon(n - nuːn)buổi trưa
emotional(adj - ɪˈməʊʃənl)tình cảm
ultimately(adv - ˈʌltɪmətli)cuối cùng - first letter: u
hairdresser(n - ˈherdresər)thợ cắt tóc
carpet(n - ˈkɑːrpɪt)thảm
slip, trip(v - slɪp, trɪp)trượt chân
paperwork(n - ˈpeɪpərwɜːrk)thủ tục giấy tờ
wildlife(n - ˈwaɪldlaɪf)đông vật hoang dã
ferry(n - ˈferi)phà
flight attendant(n - ˈflaɪt ətendənt)tiếp viên hàng không
technician(n - tekˈnɪʃn)kỹ thuật viên
official(n - əˈfɪʃl)quan chức
ornamental(adj - ˌɔːrnəˈmentl)trang trí - adj
long-lived(adj - ˌlɔːŋ ˈlɪvd)sống lâu năm
Swedish(adj  - ˈswiːdɪʃ)người Thụy Điển
accommodation(n - əˌkɑːməˈdeɪʃn)chỗ ở
Arctic(adj - ˈɑːrktɪk)Bắc Cực
crowded(adj - ˈkraʊdɪd)đông người
adventurous(adj - ədˈventʃərəs)mạo hiểm
vacationer(n - veɪˈkeɪʃənər)người nghỉ dưỡng
fur(n - fɜːr)lông ~ lông động vật
closet(n - ˈklɑːzɪt)tủ
junction(n - ˈdʒʌŋkʃn)ngã ba
recreation center(n  - ˌriːkriˈeɪʃn ˈsentər)trung tâm giải trí (tìm trong cambridge dictionary)
exempt(adj - ɪɡˈzempt)miễn
heritage(n - ˈherɪtɪdʒ)di sản
monument(n - ˈmɑːnjumənt)di tích
citadel(n - ˈsɪtədəl)thành ~ thành trì
universal(adj - ˌjuːnɪˈvɜːrsl)chung
liberty(n - ˈlɪbərti)tự do
triumph(n - ˈtraɪʌmf)chiến thắng
oppression(n - əˈpreʃn)sự áp bức
railway(n - ˈreɪlweɪ)đường sắt
outstanding(adj - aʊtˈstændɪŋ)điển hình, nổi bật
geological(adj - ˌdʒiːəˈlɑːdʒɪkl)địa chất
attentive(adj - əˈtentɪv)niềm nở
seasoning(n - ˈsiːzənɪŋ)đồ gia vị
formation(n - fɔːrˈmeɪʃn)sự hình thành
lifestyle(n - ˈlaɪfstaɪl)lối sống
mountainous(adj - ˈmaʊntənəs)miền núi - 2 âm tiết
pasture(n - ˈpæstʃər)đồng cỏ
upland(n - ˈʌplənd)vùng cao
landmark(n - ˈlændmɑːrk)bước ngoặt
harmonise(v - ˈhɑːrmənaɪz)hài hòa
architect(n - ˈɑːrkɪtekt)kiến trúc sư
Portugal(n - ˈpɔːrtʃʊɡl)Bồ Đào Nha
port wine(n  - pɔːrt waɪn)rượu vang
evolution(n - ˌevəˈluːʃn)sự tiến hóa
humid(adj - ˈhjuːmɪd)ẩm
thriller(n - ˈθrɪlər)phim kinh dị
appearance(n - əˈpɪrəns)bề ngoài, diện mạo
movement(n - ˈmuːvmənt)phong trào
liberation(n - ˌlɪbəˈreɪʃn)giải phóng
so-called(adj - ˌsəʊ ˈkɔːld)cái gọi là
trace(v - treɪs)bắt nguồn từ
advent(n - ˈædvent)ra đời
labor-saving(adj - ˈleɪbər seɪvɪŋ)tiết kiệm lao động
acquire(v - əˈkwaɪər)có được
free(adj - friː)giải thoát
endless(adj - ˈendləs)bất tận
mechanize(v - ˈmekənaɪz)cơ giới hóa
impetus(n - ˈɪmpɪtəs)động lực
vacancy(n - ˈveɪkənsi)chỗ trống
weld(v - weld)hàn
diaper(n - ˈdaɪpər)tã ~ tã lót
thankful(adj - ˈθæŋkfl)biết ơn
suppress(v - səˈpres)đàn áp
age(v - eɪdʒ)già đi
mammal(n - ˈmæml)động vật có vú
puberty(n - ˈpjuːbərti)dậy thì
adolescent(n - ˌædəˈlesnt)thanh thiếu niên
disregard(n - ˌdɪsrɪˈɡɑːrd)bỏ qua
correlate(v - ˈkɔːrəleɪt)tương quan
shift(n - ʃɪft)sự thay đổi
alertness(n - əˈlɜːrtnəs)sự tỉnh táo
promote(v - prəˈməʊt)quảng bá, thăng chức, thúc đẩy
promotion(n - prəˈməʊʃn)quảng bá, thăng chức, chương trình khuyễn mãi
promotional(adj) khuyến mãi
academic(adj - ˌækəˈdemɪk)học tập (adj)
critical(adj - ˈkrɪtɪkl)quan trọng
consolidation(n - kənˌsɑːlɪˈdeɪʃn)củng cố
disruption(n - dɪsˈrʌpʃn)sự gián đoạn
impulsive(adj - ɪmˈpʌlsɪv)bốc đồng
empathy(n - ˈempəθi)đồng cảm - n
moody(adj - ˈmuːdi)thất thường
insensitive(adj - ɪnˈsensətɪv)vô cảm
metabolic(adj - ˌmetəˈbɑːlɪk)trao đổi chất
blood glucose(n - blʌd ˈɡluːkəʊs)đường huyết
diabetes(n - ˌdaɪəˈbiːtiːz)tiểu đường
comparable(adj - ˈkɑːmpərəbl)tương đương
indulgence(n - ɪnˈdʌldʒəns)ham muốn
sleepy(adj - ˈsliːpi)buồn ngủ
grumpy, irritable(adj - ˈɡrʌmpi ˈɪrɪtəbl)cáu kỉnh
overly(adv - ˈəʊvərli)quá
caffeinated(adj - ˈkæfɪneɪtɪd)chứa cafein
bear(v - ber)chịu ~ chịu đựng
tremendous(adj - trəˈmendəs)to lớn
argumentative(adj - ˌɑːrɡjuˈmentətɪv)tranh luận
rather(adv - ˈræðər)khá | It rather small comapred to everything else
cyberspace(n - ˈsaɪbərspeɪs)không gian mạng
strengthen(v - ˈstreŋkθn)củng cố
democracy(n - dɪˈmɑːkrəsi)dân chủ
end(file)
