28
23
insist that(v - ɪnˈsɪst)khẳng định
debate(n - dɪˈbeɪt)tranh luận
fascinate(v - ˈfæsɪneɪt)mê hoặc
admission(n - ədˈmɪʃn)cho phép
quantity(n - ˈkwɑːntəti)số lượng
trial(n - ˈtraɪəl)xét xử
decrease(v - dɪˈkriːs)giảm, giảm xuống
bake(v - dɪˈkriːs)nướng
monitor(n - ˈmɑːnɪtər)theo dõi
frustrate(v - ˈfrʌstreɪt)bực bội
debt(n - det)món nợ
capital(n - ˈkæpɪtl)thủ đô
concentrate(v - ˈkɑːnsntreɪt)tập trung
interfere(v - ˌɪntərˈfɪr)gây trở ngại
passive(adj - ˈpæsɪv)bị động
dinosaur(n - ˈdaɪnəsɔːr)khủng long
ingredient(n - ɪnˈɡriːdiənt)thành phần
shelf(n - ʃelf)kệ
mission(n - ˈmɪʃn)nhiệm vụ
lightly(adv - ˈlaɪtli)nhẹ
fund(n - fʌnd)quỹ, số tiền
exhibit(v - ɪɡˈzɪbɪt)triển lãm
ruin(n - ˈruːɪn)tàn tích
blame(v - bleɪm)khiển trách, dẫn đến
gentle(adj - ˈdʒentl)dịu dàng
oppose(v - əˈpəʊz)chống lại, trái lại
succeed(v - səkˈsiːd)thành công
resort(v - rɪˈzɔːrt)dùng đến
tale(n - teɪl)chuyện, câu chuyện
shadow(n - ˈʃædəʊ)bóng
path(n - pæθ)con đường
factual(adj - ˈfæktʃuəl)thực tế
chemistry(n - ˈkemɪstri)hóa học
fame(n - feɪm)danh tiếng
depart(v - dɪˈpɑːrt)khởi hành
mess(n - mes)hỗn độn
division(n - dɪˈvɪʒn)bộ phận
branch(n - bræntʃ)cành cây
cast(v - kæst)quăng
grand(adj - ɡrænd)lớn
ordinary(adj - ˈɔːrdneri)bình thường
permanent(adj - ˈpɜːrmənənt)dài ngày, vĩnh cửu
jail(n - dʒeɪl)nhà tù
shut(v - ʃʌt)đóng
symptom(n - ˈsɪmptəm)triệu chứng
minister(n - ˈmɪnɪstər)bộ trưởng
bold(adj - bəʊld)can đảm
tight(adj - taɪt)chặt
expose(v - ɪkˈspəʊz)lộ ra, phơi bày
resemble(v - rɪˈzembl)giống nhau
inn(n - ɪn)nhà trọ
whisper(v - ˈwɪspər)thì thầm
dare(v - der)dám
sharp(adj - ʃɑːrp)sắc
pot(n - pɑːt)nồi
subtract(v - səbˈtrækt)phép trừ
philosophy(n - fəˈlɑːsəfi)triết lý
duke(n - duːk)công tước
tobacco(n - təˈbækəʊ)thuốc lá
net(n - net)lưới
fuel(n - ˈfjuːəl)nhiên liệu
firm(n - fɜːrm)chắc chắn
deck(n - dek)boong tàu
reef(n - riːf)rạng san hô
coral(n - ˈkɔːrəl)san hô
preserve(v - prɪˈzɜːrv)bảo vệ, duy trì
twin(n - twɪn)cặp sinh đôi, cặp song sinh, sinh đôi, song sinh
hurricane(n - ˈhɜːrəkeɪn/ 2)bão, cơn bão
surf(n - sɜːrf)lướt sóng
witch(n - wɪtʃ)phù thủy
zone(n - zəʊn)vùng
crash(n - kræʃ)tai nạn
adjust(v - əˈdʒʌst)cải tiến
capture(v - ˈkæptʃər)chụp
bare(adj - ber)trần
accompany(v - əˈkʌmpəni)đồng hành, đi kèm
engage/ hire(v - ɪnˈɡeɪdʒ, ˈhaɪər)thuê
amuse(v - əˈmjuːz)giải trí
innocent(adj - ˈɪnəsnt)vô tội
strict(adj - strɪkt)nghiêm khắc
guilty(adj - ˈɡɪlti)có lỗi
end(file)