commonly: phổ biến
constantly: liên tục
ultimately: cuối cùng
deny: phủ nhận, từ chối
bid: giá thầu
accompany: đi kèm
emphasis: sự chú trọng
admirably: một cách đáng ngưỡng mộ
ability: trình độ
owing to = due to: do
unlikely: khó có thể
regarding = about: về
reckless: liều lĩnh
opposite: đối diện
illustration: hình minh họa
charming: cuốn hút
endure: lâu dài
scarcely: hiếm hoi
are zoned: được phân vùng
prescription: đơn thuốc
apparent: rõ ràng
tentative: tạm thời
evidently: rõ ràng
abundant: nhiều, đa dạng
stepping down: rời vị trí, từ chức
opponent: sự phản đối, đối thủ
entitle: cho phép
recipient: người nhận
apparel: trang phục
amend: sửa
wire hangers: móc treo
detergent: chất tẩy rửa
progress: tiến độ
enjoyable: thú vị
stuffing: nhét
pie tin: khuôn bánh nướng
panel: hội đồng, ban, bệ
the effects: tác động
trial: thử nghiệm
outcome: kết quả
expedite: đẩy nhanh
tailored: phù hợp
demolished: phá dỡ
welcome: đáng hoan nghênh
complementing: bổ sung
preliminary: sơ bộ
rinse: rửa
handbag: túi xách
intermission: giải lao
medication: thuốc
shelter: nơi ở
accomplishment: thành tựu
an application for financial assistance: đơn xin hỗ trợ tài chính
settle: giải quyết
hall: hành làng
city hall/ town hall: tòa thị chính
commuter: người đi làm
expect: dự kiến
parade: diễu hành
comedian: diễn viên hài
reporting that: đưa tin rằng
nearly: hầu hết
nearby: gần
corridor: hành lang
pick up: điểm đón/đón
compact: nhỏ gọn
retreat: nghỉ dưỡng

duty: trách nhiệm
dispute: tranh cãi
