20
14
travel(v - ˈtrævl)di chuyển, đi | lưu ý travel không phải là đi du lịch
front desk(n - ˌfrʌnt ˈdesk)quầy lễ tân
lobby(n - ˈlɑːbi)sảnh
scout(v - skaʊt)tìm kiếm
lift(n - lɪft)thang máy
seminar(n - ˈsemɪnɑːr)hội thảo
vice chancellor(n - ˌvaɪs ˈtʃænsələr)phó hiệu trưởng
administrator(n - ədˈmɪnɪstreɪtər)quản trị viên
drag(n - dræɡ)khó khăn
cluster(n - ˈklʌstər)cụm
curiosity(n - ˌkjʊriˈɑːsəti)tò mò
outrageous(adj - aʊtˈreɪdʒəs)thái quá
companion(n - kəmˈpænjən)bạn đồng hành
politician(n - ˌpɑːləˈtɪʃn)chính khách
professionally(adv - prəˈfeʃənəli)chuyên nghiệp
enegertic(adj - ˌenərˈdʒetɪk)năng động
rollerblade, roller skating(v - ˈrəʊlərbleɪd)trượt patin
junior(n - ˈdʒuːniər)trẻ nhỏ
domestic(n - dəˈmestɪk)nội trợ
recruit(v - rɪˈkruːt)tuyển dụng
actively(adv - ˈæktɪvli)tích cực
still(adv - stɪl)tuy nhiên
openly(adv - ˈəʊpənli)công khai
display(v - dɪˈspleɪ)thể hiện, trưng bày, hiển thị
affection(n - əˈfekʃn)tình cảm
yield(n - jiːld)mang lại
contribution(n - ˌkɑːntrɪˈbjuːʃn)đóng góp
fulfilling(adj - fʊlˈfɪlɪŋ)viên mãn
attend(v - əˈtend)tham gia
validate(v - ˈvælɪdeɪt)xác thực
emphasis(n - ˈemfəsɪs)sự chú trọng
law-abiding(adj - ˈlɔː əbaɪdɪŋ)tuân thủ pháp luật
requirement(n - rɪˈkwaɪərmənt)yêu cầu
function(v - ˈfʌŋkʃn)hoạt động
model(v - ˈmɑːdl)mô hình hóa, làm gương ~ parents need to model a responsible lifestyle for their children.
aridity( - əˈrɪdəti)khô cằn
geographer(n - dʒiˈɑːɡrəfər)nhà địa lý
continent(n - ˈkɑːntɪnənt)lục địa
antarctica(n - ænˈtɑːrktɪkə)nam cực
rainfall(n - ˈreɪnfɔːl)lượng mưa
searing(adj - ˈsɪrɪŋ)khắc nghiệt
evaporation(n - ɪˌvæpəˈreɪʃn)bốc hơi
dam(n - dæm)đập nước
seep, penetrate(v - siːp, ˈpenətreɪt)thấm
collect(v - kəˈlekt)tích tụ
subterranean( - ˌsʌbtəˈreɪniən)dưới lòng đất
pump(v - pʌmp)bơm
irrigation(n - ˌɪrɪˈɡeɪʃn)tưới tiêu
extent(n - ɪkˈstent)phạm vi, mức độ
inland(adv - ˌɪnˈlænd)nội địa
reservoir(n - ˈrezərvwɑːr)hồ chứa
bubble(n - ˈbʌbl)nổi bọt
spring(n - sprɪŋ)con suối
pioneer(n - ˌpaɪəˈnɪr)người tiên phong
early(adj - ˈɜːrli)ban đầu
drastically(adv - ˈdræstɪkli)trầm trọng
necessitate(v - nəˈsesɪteɪt)đòi hỏi
consumption(n - kənˈsʌmpʃn)tiêu thụ
ecosystem(n - ˈiːkəʊsɪstəm)hệ sinh thái
regulate(v - ˈreɡjuleɪt)điều tiết
rural(adj - ˈrʊrəl)vùng nông thôn
tap, harness(v - ˈhɑːrnɪs, tæp)khai thác
outback(n - ˈaʊtbæk)hẻo lánh
case(n - keɪs)tình huống, trường hợp
area(n - ˈeriə)lĩnh vực
sour(adj - ˈsaʊər)chua
depletion(n - dɪˈpliːʃn)cạn kiệt
hydraulic(adj - haɪˈdrɔːlɪk)thủy lực
aquatic(adj - əˈkwɑːtɪk)thủy sinh
geyser(n - ˈɡaɪzər)mạch nước phun
boundless(adj - ˈbaʊndləs)vô hạn
complete(adj - kəmˈpliːt)đầy đủ
accumulate(v - əˈkjuːmjəleɪt)tích lũy
qualification(n - ˌkwɑːlɪfɪˈkeɪʃn)bằng cấp, trình độ, khả năng chuyên môn
gain(v - ɡeɪn)đạt được
fulfill(v - fʊlˈfɪl)hoàn thành
lifelong(adj - ˈlaɪflɔːŋ)cả đời
recognition(n - ˌrekəɡˈnɪʃn)sự công nhận
bond(v - bɑːnd)gắn kết
end(file)