0
## test 10th
wheel: bánh xe
reinforcement: gia cố
emerging: mới nổi
just as: ngay khi
in light of: vì, xét theo
supplemental: bổ sung
eco-friendly: thân thiện với môi trường
mix: hỗn hợp
flow: chảy
landscape(v): tạo cảnh quan
rainfall: lượng mưa
best of all: trên hết
premier: hàng đầu
auction: cuộc đấu giá
innovation: sự đổi mới
criticism: sự chỉ trích
shot: bức ảnh
shoot: buổi chụp ảnh
superior (adj): vượt trội
screw: đinh vít
bolt: bu lông
interoffice: giữa các văn phòng
botanical: thực vật
marble: cẩm thạch
coordinate: tọa độ
fellow: giống bạn
attendant: nhân viên
delectable: ngon miệng
treat: món ăn
compact: nhỏ gọn
perk: phúc lợi
worthwhile: đáng giá
it so happen: thật tình cờ
crushed gravel: sỏi nghiền
rollout: triển khai
wipe off: lau
brush: phủi
shovel: xúc
fixture: đồ đạc
peach: đào
uneventful: không có gì đáng kể
cargo ship: tàu hàng
shipping: vận chuyển
meteorology: khí tượng học
terrace: sân thượng
not at all: không sao đâu
stamp: đóng dấu
cake, pie, cookies: bánh ngọt, bánh nướng, bánh quy
sweetener: chất làm ngọt
textile: dệt may
a flat tire: lốp xe bị xẹp
relief: sự nhẹ nhõm
wide-mouthed lid: nắp miệng rộng
straw: ống hút
pencil drawing: bức vẽ bút chì
mix-up: nhầm lẫn
clay sculptures: điêu khắc đất sét
offshore: ngoài khơi
repave: lát lại
trowel: cái bai
crowbar: thanh cậy
cement: xi măng
seal: trám
chip: vết sứt
botanist: thực vật học
orchild plant: cây phong lan
concession: đồ ăn nhẹ
vibrant: rực rỡ
royal: hoàng gia
rough: thô
