25
17
critical(adj - ˈkrɪtɪkl)phê bình
sympathetic(adj - ˌsɪmpəˈθetɪk)đồng cảm - adj
emerge(v - ɪˈmɜːrdʒ)xuất hiện
pillow(n - ˈpɪləʊ)cái gối
garnish(v - ˈɡɑːrnɪʃ)trang trí - verb, first letter: g
lettuce(n - ˈletɪs)rau diếp
reluctant(adj - rɪˈlʌktənt)bất đắc dĩ
overwhelm(v - ˌəʊvərˈwelm)choáng ngợp
inconsiderate(adj - ˌɪnkənˈsɪdərət)thiếu cân nhắc
regain(v - rɪˈɡeɪn)lấy lại
Fahrenheit(adj - ˈfærənhaɪt)độ f
projector(n - prəˈdʒektər)máy chiếu
existing(adj - ɪɡˈzɪstɪŋ)tồn tại, hiện tại, hiện có
routine(n - ruːˈtiːn)công việc hằng ngày, thói quen
potted(adj - ˈpɑːtɪd)trong chậu
stitching(n - ˈstɪtʃɪŋ)đường khâu
sustain(v - səˈsteɪn)duy trì
associated(adj - əˈsəʊʃieɪtɪd)liên quan - adj
waterway(n - ˈwɔːtərweɪ)đường thủy
subsidiary(adj - səbˈsɪdieri)công ty con
retain(v - rɪˈteɪn)giữ lại
greenery(n - ˈɡriːnəri)cây xanh
preservation(n - ˌprezərˈveɪʃn)duy trì
county(n - ˈkaʊnti)quận
project(v - ˈprɑːdʒekt)dự kiến
classified(adj - ˈklæsɪfaɪd)phân loại
mind(n - maɪnd)tâm trí
originate(v - əˈrɪdʒɪneɪt)có nguồn gốc
recreational(adj - ˌrekriˈeɪʃənl)giải trí
context(n - ˈkɑːntekst)bối cảnh
daredevil(n - ˈderdevl)liều lĩnh
railing(n - ˈreɪlɪŋ)lan can
magnificent(adj - mæɡˈnɪfɪsnt)tráng lệ, đẹp đẽ
mainstream(n - ˈmeɪnstriːm)chính thống
adopt(v - əˈdɑːpt)thông qua, áp dụng
cycling(n - ˈsaɪklɪŋ)đi xe đạp
discipline(n - ˈdɪsəplɪn)bộ môn
in-line skating(n - ˌɪn laɪn ˈskeɪtɪŋ)trượt patin
jurisdiction(n - ˌdʒʊrɪsˈdɪkʃn)quyền hạn
characterize(v - ˈkærəktəraɪz)đặc trưng
used(adj - juːst)quen thuộc
mapping(n - ˈmæpɪŋ)ánh xạ
ritual(n - ˈrɪtʃuəl)nghi lễ
practice(n - ˈpræktɪs)thực hiện
vine(n - vaɪn)dây leo
wind(n - wɪnd)quấn
cord(n - kɔːrd)dây
rope(n - rəʊp)dây thừng
yam(n - jæm)khoai mỡ
harvest(n - ˈhɑːrvɪst)thu hoạch
plentiful(adj - ˈplentɪfl)dồi dào
handful(n - ˈhændfʊl)một số ít
once(adv - wʌns)đã từng
thrill(n - θrɪl)cảm giác mạnh
fatal(adj - ˈfeɪtl)gây tử vong
alternative(adj - ɔːlˈtɜːrnətɪv)thay thế
alternative(n - ɔːlˈtɜːrnətɪv)cách thay thế, lựa chọn thay thế
snap, sever(v - snæp, sevər)bị đứt
leap(v - liːp)nhảy vọt
crane(n - kreɪn)cần cẩu
rubber band(n - ˌrʌbər ˈbænd)dây cao su
skyward(adv - ˈskaɪwərdz)lên trời
psychological(adj - ˌsaɪkəˈlɑːdʒɪkl)tâm lý
enrich(v - ɪnˈrɪtʃ)làm giàu
lasting(adj - ˈlæstɪŋ)lâu dài
decisive(adj - dɪˈsaɪsɪv)dứt khoát
keep(v - kiːp)tiếp tục
draw(n - drɔː)sức hút
existence(n - ɪɡˈzɪstəns)tồn tại
original(adj - əˈrɪdʒənl)ban đầu - adj
end(file)