11
24
tip(n - tɪp)tiền boa
render(v - ˈrendər)cung cấp
courtesy(n - ˈkɜːrtəsi)phép lịch sự
affair(n - əˈfer)vấn đề
initial(n - ɪˈnɪʃl)tên viết tắt
bellhop(n - ˈbelhɑːp)nhân viên phục vụ khách sạn
chambermaid(n - ˈtʃeɪmbərmeɪd)nhân viên dọn phòng khách sạn
gratuity(n - ɡrəˈtuːəti)tiền thưởng
nature(n - ˈneɪtʃər)bản chất
merit(v - ˈmerɪt)xứng đáng nhận
skycap porter( - ˈskaɪkæp ˈpɔːrtər)người khuân vác ở sân bay
metropolitan(adj - ˌmetrəˈpɑːlɪtən)đô thị		The New York metropolitan area
mandatory(adj - ˈmændətɔːri)bắt buộc			It is mandatory for blood banks to test all donated blood for the virus.
noticeably(adv - ˈnəʊtɪsəbli)dễ nhận thấy 		Her hand was shaking (rung lên) noticeably
likewise(adv - ˈlaɪkwaɪz)tương tự như vậy		He voted for the change and he expected his colleagues to do likewise.
nuisance(n - ˈnuːsns)phiền toái					It's a nuisance having to go back tomorrow.
favor(n - ˈfeɪvər)sự giúp đỡ 					The programme has lost favor with viewers recently/ could you do me a favor?
consensus(n - kənˈsensəs)sự nhất trí		There is a growing (ngày càng nhiều) consensus of opinion on this issue
favor(v - ˈfeɪvər)ủng hộ                    Many countries favour a presidential system 'hệ thống tổng thống"
fool, trick(v -   - fuːl)đánh lừa
mislead(v - ˌmɪsˈliːd)đánh lạc hướng		You don't fool me!	
letter(n - ˈletər)chữ cái					‘B’ is the second letter of the alphabet.
abbreviation(n - əˌbriːviˈeɪʃn)viết tắt		What's the abbreviation for ‘Saint’?
neutral(adj - ˈnuːtrəl)trung lập			Journalists are supposed to (được cho là) be politically neutral.	
sizable(adj - ˈsaɪzəbl)khá lớn				The town has a sizeable Sikh (đạo Sikh) population.
banknote(n - ˈbæŋknəʊt)tiền giấy
politeness(n - pəˈlaɪtnəs)lịch sự			He stood up out of politeness and offered her his seat (anh ta đứng lên vì lịch sự và nhường ghế cho cô)
responsive(adj - rɪˈspɑːnsɪv)phản ứng nhanh nhạy		Firms have to be responsive to consumer demand
perfectly(adv - ˈpɜːrfɪktli)hoàn toàn		It's perfectly normal to feel like this
retrieve(v - rɪˈtriːv)tìm lại, lấy			The dog retrieved the ball from the water.
chin(n - tʃɪn)cằm
assumption(n - əˈsʌmpʃn)giả thiết			implicit assumption (giả thiết ẩn)
commercial(adj - kəˈmɜːrʃl)thương mại, quảng cáo		residential and commercial properties (tài sản dân cư và thương mại)
druggist(n - ˈdrʌɡɪst)nhà dược học
syrup(n - ˈsɪrəp)si rô
nut(n - nʌt)hạt							to crack a nut
beverage(n - ˈbevərɪdʒ)đồ uống			laws governing (quản lý) the sale of alcoholic beverages
bitter(adj - ˈbɪtər)đắng
bark(n - bɑːrk)vỏ cây
porch(n - pɔːrtʃ)hiên nhà
basement(n - ˈbeɪsmənt)tầng hầm
easy-going(adj - ˌiːzi ˈɡəʊɪŋ)dễ dãi
sheet(n - ʃiːt)ga ~ ga giường 
drawer(n - drɔːr)ngăn kéo
residence hall(n - ˈrezɪdəns hɔːl)ký túc xá
premium(n - ˈpriːmiəm)mức cao
kitchenette(n - ˌkɪtʃɪˈnet)bếp nhỏ
tenant(n - ˈtenənt)người thuê
union(n - ˈjuːniən)hiệp hội				Teachers' unions in England are demanding the same improvements as in Scotland
keen(adj - kiːn)muốn
quote(v - kwəʊt)báo giá
trading(n - ˈtreɪdɪŋ)giao dịch
recycle(v - ˌriːˈsaɪkl)tái chế
waste(n - weɪst)rác thải
meet(v - miːt)đáp ứng
emission(n - ɪˈmɪʃn)khí thải
landfill(n - ˈlændfɪl)bãi rác
virgin(n - ˈvɜːrdʒɪn)thô (nguyên liệu thô)
baling(v - beɪl)đóng kiện (đóng hàng thành từng kiện)
place(n - pleɪs)đặt
filtration(n - fɪlˈtreɪʃn)lọc
fiberglass(n - ˈfaɪbərɡlæs)sợi thủy tinh
conditioner(n - kənˈdɪʃənər)chất điều hòa
plant(n - plænt)nhà máy
incineration(n - ɪnˌsɪnəˈreɪʃn)thiêu hủy rác
dispose(v - dɪˈspəʊz)vứt bỏ
business card(n - ˈbɪznəs kɑːrd)danh thiếp
stand, stall(n  - stɔːl, stænd)quầy - quầy đồ ăn/nước/bánh
literature(n - ˈlɪtrətʃər)văn học
impractical(adj - ɪmˈpræktɪkl)không thực tế
discourage(v - dɪsˈkɜːrɪdʒ)chán nản
shampoo(n - ʃæmˈpuː)dầu gội đầu
oatmeal(adj - ˈəʊtmiːl)lúa mạch
cellist(n - ˈtʃelɪst)nghễ sĩ chơi đàn cello
piece(n - piːs)tác phẩm nghệ thuật (They performed pieces by Bach and Handel)
snack(n - snæk)bữa ăn nhẹ
sociology(n - ˌsəʊsiˈɑːlədʒi)xã hội học
supervision(n - ˌsuːpərˈvɪʒn)giám sát
possible(adj - ˈpɑːsəbl)có thể xảy ra
term(v - tɜːrm)được gọi là
case study(n - ˈkeɪs stʌdi)nghiên cứu điển hình
phase(n - feɪz)giai đoạn
warm-up(n - ˈwɔːrm ʌp)khởi động
ease(n - iːz)thoải mái
verbal(adj - ˈvɜːrbl)bằng lời nói
colloquial(adj - kəˈləʊkwiəl)thông thường
restate(v - ˌriːˈsteɪt)trình bày lại
presumably(adv - prɪˈzuːməbli)có lẽ
glass(n - ɡlæs)thủy tinh
use(n - juːz)ứng dụng
aggregate(n - ˈæɡrɪɡət)tổng hợp
smell(v - smel)mùi hôi
invasion(n - ɪnˈveɪʒn)sự xâm nhập
fungal(adj - ˈfʌŋɡl)nấm
series(n - ˈsɪriːz)loạt (một loạt các hành động ... )
infection(n - ɪnˈfekʃn)sự lây nhiễm
organism(n - ˈɔːrɡənɪzəm)sinh vật
disease(n - dɪˈziːz)gây bệnh
vessel(n - ˈvesl)mạch(mạch máu)
decay(n - dɪˈkeɪ)sâu, mục nát(The decay of the wood will spread if it is not removed)
hollow(adj - ˈhɑːləʊ)rỗng
cross section(n - ˈkrɔːs sekʃn)mặt cắt ngang
pith(n - pɪθ)trụ
advance(v - ədˈvæns)tiến vào/thúc đẩy
inward(adj - ˈɪnwərd)hướng vào
halt(v - hɔːlt)ngăn chặn
project(v - ˈprɑːdʒekt)chiếu
radially(adv - ˈreɪdiəli)xuyên tâm
inner(adj - ˈɪnər)bên trong
retard(v - rɪˈtɑːrd)làm chậm
crack(v - kræk)vết nứt
overpriced(adj - ˌəʊvərˈpraɪst)đắt đỏ
overcharging(v - ˌəʊvərˈtʃɑːrdʒ)tính phí quá cao
unauthorized(adj - ʌnˈɔːθəraɪzd)trái phép
inferior(adj - ɪnˈfɪriər)kém hơn
ray(n - reɪ):tia(tia chiếu)
susceptible(adj - səˈseptəbl)nhạy cảm
closure(n - ˈkləʊʒər)đóng, việc đóng cửa
visualize(v - ˈvɪʒuəlaɪz)hình dung
acknowledge(v - əkˈnɑːlɪdʒ)xác nhận, thừa nhận, công nhận
end(file)
