12
11
ensure(v - ɪnˈʃʊr)đảm bảo
specialist(n - ˈspeʃəlɪst)chuyên gia
rug(n - rʌɡ)tấm thảm
coupon(n - ˈkjuːpɑːn)phiếu khuyến mãi
exception(n - ɪkˈsepʃn)sự ngoại lệ
financial(aj - faɪˈnænʃl)tài chính
accounting(n - əˈkaʊntɪŋ)kế toán
profession(n - prəˈfeʃn)nghề nghiệp
bleach(v - bliːtʃ)tẩy trắng
fulfillment(n - fʊlˈfɪlmənt)sự hoàn tất, thỏa mãn
issue(n - ˈɪʃuː)cấp phát
pleasure(n - ˈpleʒər)vinh dự
backpack(n - ˈbækpæk)ba lô
suitcase(n - ˈsuːtkeɪs)vali du lịch
briefcase(n - ˈbriːfkeɪs)vali công tác
firefighter(n - ˈfaɪərfaɪtər)lính cứu hỏa
grocery(n - ˈɡrəʊsəri)cửa hàng tạp hóa
entrepreneur(n - ˌɑːntrəprəˈnɜːr)doanh nhân
revenue(n - ˈrevənuː)doanh thu
wisdom(n - ˈwɪzdəm)khôn ngoan
manufacturing(n - ˌmænjuˈfæktʃərɪŋ)sản xuất
balcony(n - ˈbælkəni)ban công
seaside(n - ˈsiːsaɪd)bên bờ biển
dump(v - dʌmp)khờ dại
inspiration(n - ˌɪnspəˈreɪʃn)cảm hứng
affordable(adj - əˈfɔːrdəbl)hợp lý
rate(n - reɪt)tỷ giá
latest(adj - ˈleɪtɪst)mới nhất
traveller(n - ˈtrævələr)du khách
intention(n - ɪnˈtenʃn)ý định
leisure(n - ˈliːʒər)thời gian rảnh rỗi, giải trí
representative(n - ˌreprɪˈzentətɪv)người đại diện
set out(phrasal verb)khởi hành
located(adj - ˈləʊkeɪtɪd)tọa lạc
destination(n - ˌdestɪˈneɪʃn)nơi đến
departure(n - dɪˈpɑːrtʃər)khởi hành
obituary(n - əʊˈbɪtʃueri)cáo phó
tour(n - tʊr)lưu diễn
concert(n - ˈkɑːnsərt)buổi hòa nhạc
violinist(n - ˌvaɪəˈlɪnɪst)nghệ sỹ violin
aide(n - eɪd)trợ lý
beloved(adj - bɪˈlʌvɪd)yêu dấu
luxury(n - ˈlʌkʃəri)sang trọng
hemisphere(n - ˈhemɪsfɪr)bán cầu
aromatherapy(n - əˌrəʊməˈθerəpi)dược liệu
exhibition(n - ˌeksɪˈbɪʃn)buổi triển lãm
european(adj - ˌjʊrəˈpiːən)người châu âu
pacific(adj - pəˈsɪfɪk)thái bình dương
carve(v - kɑːrv)chạm khắc
evil(adj - ˈiːvl)quỷ dữ
spirit(n - ˈspɪrɪt)linh hồn, tinh thần
buddhist(adj - ˈbuːdɪst)phật giáo
blow(v - bləʊ)thổi
contest(n - ˈkɑːntest)cuộc thi
the side( - saɪd)một bên, bên hông
type(n - taɪp)loại, kiểu
sightseeing(n - ˈsaɪtsiːɪŋ)tham quan
aromatic(adj - ˌærəˈmætɪk)thơm
council(n - ˈkaʊnsl)hội đồng
artistic(adj - ɑːrˈtɪstɪk)thuộc về nghệ thuật
via(prep - ˈvaɪə)thông qua
promising(adj - ˈprɑːmɪsɪŋ/ par)triển vọng
dedication(n - ˌdedɪˈkeɪʃn)sự cống hiến
register(v - ˈredʒɪstər)đăng ký
conduct(v - kənˈdʌkt)thực hiện
musician(n - mjuˈzɪʃn)nhạc sỹ
obviously(adv - ˈɑːbviəsli)rõ ràng là
greatly(adv - ˈɡreɪtli)đáng kể
wanted(adj - ˈwɑːntɪd)tuyển dụng, truy nã
auditorium(n - ˌɔːdɪˈtɔːriəm)khán phòng
candidate(n - ˈkændɪdət)thí sinh
follow(v - ˈfɑːləʊ)đi theo, làm theo,theo dõi, tuần thủ|have been follow - được tuân thủ
teenager(n - ˈtiːneɪdʒər)thanh thiếu niên
paintwork(n - ˈpeɪntwɜːrk)phun sơn
reliable(adj - rɪˈlaɪəbl)đáng tin cậy
sock(n - sɑːk)bít tất
pace(n - peɪs)phong độ
gotta(ˈɡɑːtə)cần phải
attached(adj - əˈtætʃt)đính kèm
media(n - ˈmiːdiə)phương tiện truyền thông
lately(adv - ˈleɪtli)gần đây
tryout(n - ˈtraɪaʊt)buổi kiểm tra thành tích
spoon(n - spuːn)cái thìa
dry(adj - draɪ)sấy khô
nutritionist(n - nuˈtrɪʃənɪst)chuyên gia dinh dưỡng
recipe(n - ˈresəpi)công thức
discrepancy(n - dɪˈskrepənsi)sự khác biệt
end(file)