# từ đã học nhưng quên nghĩa
05
referrals (n - rɪˈfɜːrəlz) giới thiệu | he got the job through referrals
seasonal employee (n - ˈsiːzənl ɪmˈplɔɪi) nhân viên thời vụ | the store hires seasonal employees during the holidays
taking inventory daily (phrase - ˈteɪkɪŋ ˈɪnvəntɔːri ˈdeɪli) kiểm kê hàng tồn kho hằng ngày | they are responsible for taking inventory daily
pick up a client (phrase - pɪk ʌp ə ˈklaɪənt) đón một khách hàng | he needs to pick up a client from the airport
at a client presentation (phrase - æt ə ˈklaɪənt ˌprezənˈteɪʃən) buổi thuyết trình với khách hàng | she performed well at a client presentation
office complex (n - ˈɔːfɪs ˈkɒmplɛks) khu/khu phức hợp văn phòng | the new office complex is very modern
Management (n - ˈmænɪdʒmənt) ban quản lý | the management team is meeting today
just in time (phrase - dʒʌst ɪn taɪm) vừa kịp lúc | he arrived just in time for the meeting
stationery (n - ˈsteɪʃənri) văn phòng phẩm | the company ordered new stationery
faith (n - feɪθ) lòng tin, tin tưởng | she has faith in her team's abilities
trainee (n - treɪˈniː) thực tập sinh | the trainee is learning quickly
convention (n - kənˈvɛnʃən) hội nghị | the convention will be held in the main hall
accustomed (adj - əˈkʌstəmd) quen với | she is accustomed to the new routine
admit (v - ədˈmɪt) thừa nhận | he admitted his mistake
cuisine (n - kwɪˈziːn) món ăn | the restaurant specializes in French cuisine
herbs (n - ɜːrbz) thảo mộc | fresh herbs are used in the dishes
prompt shipments (phrase - prɑmpt ˈʃɪpmənts) việc giao hàng nhanh chóng | the company is known for prompt shipments
shortage (n - ˈʃɔːrtɪdʒ) sự thiếu hụt | there is a shortage of staff
stock (n - stɒk) hàng hóa | the stock is kept in the warehouse
primarily (adv - praɪˈmɛrəli) chủ yếu | the product is aimed primarily at young people
charge (n - tʃɑrdʒ) việc tính phí, khoản phí | there is a small charge for delivery
charge (v - tʃɑrdʒ) tính phí | they charge a fee for late payments
for over a decade (phrase - fɔr ˈoʊvər ə ˈdɛkeɪd) hơn 1 thập kỷ | the company has been in business for over a decade
portray (v - pɔrˈtreɪ) mô tả | the book portrays the life of the artist
receipt (n - rɪˈsiːt) biên nhận, biên lai | keep the receipt for your records
uniquely placed (phrase - juˈnikli pleɪst) có vị trí độc đáo | the hotel is uniquely placed in the heart of the city
prominent (adj - ˈprɑmɪnənt) nổi bật | she is a prominent figure 'nhân vật' in the community
proportion (n - prəˈpɔːrʃn) tỷ lệ | a large proportion of the population 'dân số' is under 18
put in an order () đặt hàng | they put in an order for new supplies
rebate () giảm giá | customers can claim a rebate on their purchase
dining room (n - ˈdaɪnɪŋ rum) phòng ăn | the dining room is elegantly decorated
the personnel office (phrase - ðə pərsəˈnɛl ˈɔfɪs) phòng nhân sự | please contact the personnel office for assistance
a file drawer (n - ə faɪl drɔr) ngăn kéo tài liệu | she kept the documents in a file drawer
a man is removing his jacket (phrase - ə mæn ɪz rɪˈmuːvɪŋ hɪz ˈdʒækɪt) đang cởi áo khoác | a man is removing his jacket in the hallway
sweep a dock (phrase - swip ə dɑk) quét dọn bến tàu | the workers sweep the dock every morning
putting up a metal barrier (phrase - ˈpʊtɪŋ ʌp ə ˈmɛtl ˈbæriər) dựng lên một rào chắn kim loại | they are putting up a metal barrier around the site
where are new printers being made () máy in được sản xuất ở đâu | where are new printers being made?
a storage closet (n - ə ˈstɔrɪʤ ˈklɑzɪt) kho quần áo | the storage closet is full
I'll have a glass with breakfast () uống 1 ly nước với bữa sáng 
inspector (n - ɪnˈspɛktər) thanh tra | the inspector visited the factory yesterday
We're glad that you're considering us to meet the energy needs of your factory () cân nhắc chúng tôi để đáp ứng nhu cầu năng lượng nhà máy của bạn | we're glad that you're considering us to meet the energy needs of your factory
supplementary: bổ sung
whose: mà có | the house whose doors are painted red has been sold