12
13
postman(n - ˈpəʊstmən)bưu tá
tailor(n - ˈteɪlər)thợ may
electrician(n - ɪˌlekˈtrɪʃn)thợ điện
barber(n - ˈbɑːrbər)thợ cắt tóc nam
plumber(n - ˈplʌmər)thợ sửa ống nước
sweater(n - ˈswetər)áo len
tank top(n - ˈtæŋk tɑːp)áo ba lỗ
skirt(n - skɜːrt)váy rời
jeans(n - dʒiːnz)quần jean
shorts(n - ʃɔːrts)quần đùi
jacket(n - ˈdʒækɪt)áo khoác
swimsuit(n - ˈswɪmsuːt)đồ bơi
goggles(n - ˈɡɑːɡlz)kính bơi
sunglasses(n - ˈsʌnɡlæsɪz)kính râm
glove(n - ɡlʌv)găng tay
earring(n - ˈɪrɪŋ)bông tai
obvious(n - ˈɑːbviəs)rõ ràng
renowned/ well-known(adj - rɪˈnaʊnd,wel ˈnəʊn)nổi tiếng
terrific/ wonderful(adj - təˈrɪfɪk, ˈwʌndərfl)tuyệt vời
fascinating(adj - ˈfæsɪneɪtɪŋ)lôi cuốn
depressed(adj - dɪˈprest)suy sụp
annoyed(adj - əˈnɔɪd)khó chịu
horrified(adj - ˈhɔːrɪfaɪd)kinh hãi
confused(adj - kənˈfjuːzd)bối rối
terrified(adj - ˈterɪfaɪd)sợ hãi
embarrassed(adj - ɪmˈbærəst)xấu hổ
excited(adj - ɪkˈsaɪtɪd)hào hứng
windsurf(v - ˈwɪndsɜːrf)lướt ván
tug of war(v - tʌɡ əv ˈwɔːr)kéo co
frisbee(v - ˈfrɪzbi)ném đĩa
affluent/ wealthy/ rich(adj - ˈæfluənt, ˈwelθi, rɪtʃ)giàu
tricky/ trouble(adj - ˈtrɪki,ˈtrʌbl)khó khăn
employ/ hire(v - ɪmˈplɔɪ,ˈhaɪər)thuê
encourage/ motivate(v - ɪnˈkɜːrɪdʒ,ˈməʊtɪveɪt)khuyến khích
windfall(n - ˈwɪndfɔːl)số tiền bất ngờ nhận được
performance(adj - pərˈfɔːrməns)hiệu suất
affect/ influence/ impact(v - əˈfekt,ˈɪnfluəns,ˈɪmpækt)ảnh hưởng
measure(v - ˈmeʒər)đo
rely on/ depend on/ bank on(phrases - rɪˈlaɪ, dɪˈpend, bæŋk)dựa vào
last(adv - læst)kéo dài
notice(v - nəʊtɪs)nhận ra
create/ generate(v - kriˈeɪt, ˈdʒenəreɪt)tạo ra
discuss/ talk about/ have discussion on(v - dɪˈskʌs)thảo luận
passion(n - ˈpæʃn)đam mê
get rid of/ remove/ eliminate(v - rɪˈmuːv, ɪˈlɪmɪneɪt)loại bỏ
make effort/ attempt/ try to/ strive to(v - ˈefərt, əˈtempt, traɪ, straɪv)cố gắng
achieve/ accomplish/ attain/ gain(əˈtʃiːv, əˈkɑːmplɪʃ, əˈteɪn, ɡeɪn)đạt được
dominant(adj - dɑːmɪnənt)có ưu thế
squezing out(v - skwiːz)thay thế
local tongues(n - ləʊkl tʌŋ)tiếng địa phương
endangered(adj - ɪnˈdeɪndʒərd)nguy cơ tuyệt chủng
extinction(n - ɪkˈstɪŋkʃn)sự tuyệt chủng
roughly(adv - rʌfli)xấp xỉ
periodically(adv - pɪriˈɑːdɪkli)một cách định kỳ
resemble(adj - rɪˈzembl)giống như
martial art(n - ˌmɑːrʃl ˈɑːrt)võ thuật
rhythm(n - rɪðəm)giai điệu
ruin/ destroyed(v - ruːɪn, dɪˈstrɔɪ)phá hủy
bond/ relationship(n - bɑːnd, rɪˈleɪʃnʃɪp)mối quan hệ
solve/ resolve/ handle/ settle/ deal with(v - sɑːlv, rɪˈzɑːlv, hændl, setl, diːl)giải quyết
simply/ simple(adv, adj - sɪmpli, sɪmpl)đơn giản
mend/ fix/ repair(v - mend, fɪks, rɪˈper)sửa
imagine/ suppose(v - ɪˈmædʒɪn, səˈpəʊz)tưởng tượng
compete(v - kəmˈpiːt)cạnh tranh
distinctive/ different/ unique(adj - dɪˈstɪŋktɪv, ˈdɪfrənt, juˈniːk)khác
lower/ decrease/ decline(adj - ləʊər, dɪˈkriːs, dɪˈklaɪn)giảm xuống
appreciation(n - əˌpriːʃiˈeɪʃn)đánh giá cao, lòng cảm kích
earlobe(n - ɪrləʊb)dái tai
custom(n - kʌstəm)phong tục
consciously(adv - kɑːnʃəsli)có nhận thức
operation(n - ɑːpəˈreɪʃn)phẫu thuật
pursuit(v - pərˈsuːt)theo đuổi
characteristic(n - kærəktəˈrɪstɪk)đặc điểm
advocate(n - ˈædvəkət)biện hộ
entrepreneur(n - ɑːntrəprəˈnɜːr)doanh nhân
constant/ continual(adj - kɑːnstənt, kənˈtɪnjuəl)liên tục
keep track of/ follow(v - træk, ˈfɑːləʊ)theo dõi
flexible(adj - fleksəbl)linh hoạt
substitute(n - sʌbstɪtuːt)sự thay thế
thorough(adj - ˈθɜːrəʊ)thấu đáo
drawback(n - ˈdrɔːbæk)hạn chế
exclusive(adj - ɪkˈskluːsɪv)độc quyền
rival(n - raɪvl)đối thủ
intrusion(n - ɪnˈtruːʒn)xâm phạm
breach(v - briːtʃ)vi phạm
end(file)